//MAP CONVERTED BY dmm2tgm.py THIS HEADER COMMENT PREVENTS RECONVERSION, DO NOT REMOVE
"bX" = (
/obj/machinery/atmospherics/components/unary/vent_pump/on/layer4,
/turf/open/floor/plating,
/area/shuttle/personally_bought/do_it_yourself_large)
"cu" = (
/obj/machinery/modular_computer/preset/engineering{
	dir = 1
	},
/obj/structure/cable,
/obj/effect/turf_decal/bot_white,
/obj/machinery/digital_clock/directional/south,
/turf/open/floor/iron/dark/smooth_large,
/area/shuttle/personally_bought/do_it_yourself_large)
"cv" = (
/obj/machinery/atmospherics/components/unary/vent_scrubber/on/layer2{
	dir = 8
	},
/obj/machinery/airalarm/directional/east,
/obj/effect/mapping_helpers/airalarm/all_access,
/turf/open/floor/plating,
/area/shuttle/personally_bought/do_it_yourself_large)
"cL" = (
/obj/machinery/suit_storage_unit/industrial/personal_shuttle,
/obj/effect/turf_decal/bot_white,
/turf/open/floor/iron/dark/smooth_large,
/area/shuttle/personally_bought/do_it_yourself_large)
"eo" = (
/obj/structure/closet/firecloset/shuttle/tools,
/obj/machinery/atmospherics/pipe/smart/manifold4w/supply/hidden/layer4,
/obj/machinery/atmospherics/components/unary/vent_scrubber/on/layer2{
	dir = 1
	},
/obj/effect/turf_decal/bot_white,
/obj/machinery/airalarm/directional/south,
/obj/effect/mapping_helpers/airalarm/all_access,
/turf/open/floor/iron/dark/smooth_large,
/area/shuttle/personally_bought/do_it_yourself_large)
"ew" = (
/obj/machinery/button/door/personal_shuttle_bay_two/directional/south,
/obj/machinery/light/cold/directional/west,
/turf/open/floor/plating,
/area/shuttle/personally_bought/do_it_yourself_large)
"eL" = (
/obj/machinery/power/shuttle_engine/propulsion{
	dir = 8
	},
/obj/effect/turf_decal/stripes/line{
	dir = 8
	},
/obj/effect/turf_decal/stripes/corner,
/obj/machinery/atmospherics/components/unary/passive_vent/layer2{
	dir = 4
	},
/turf/open/floor/plating/airless,
/area/shuttle/personally_bought/do_it_yourself_large)
"fm" = (
/obj/structure/cable,
/obj/machinery/atmospherics/components/unary/vent_scrubber/on/layer2{
	dir = 8
	},
/turf/open/floor/iron/smooth_large,
/area/shuttle/personally_bought/do_it_yourself_large)
"hh" = (
/obj/machinery/power/shuttle_engine/propulsion{
	dir = 8
	},
/obj/effect/turf_decal/stripes/line{
	dir = 8
	},
/turf/open/floor/plating/airless,
/area/shuttle/personally_bought/do_it_yourself_large)
"hJ" = (
/obj/machinery/power/shuttle_engine/heater{
	dir = 8
	},
/obj/structure/window/reinforced/plasma/spawner/directional/east,
/obj/effect/turf_decal/stripes/line{
	dir = 6
	},
/obj/machinery/atmospherics/pipe/smart/manifold4w/scrubbers/hidden/layer2,
/turf/open/floor/plating/airless,
/area/shuttle/personally_bought/do_it_yourself_large)
"je" = (
/obj/structure/marker_beacon/olive,
/turf/closed/wall/mineral/titanium,
/area/shuttle/personally_bought/do_it_yourself_large)
"jT" = (
/obj/structure/extinguisher_cabinet/directional/north,
/turf/open/floor/plating,
/area/shuttle/personally_bought/do_it_yourself_large)
"ka" = (
/obj/machinery/light/cold/directional/west,
/turf/open/floor/plating,
/area/shuttle/personally_bought/do_it_yourself_large)
"kA" = (
/obj/structure/railing/eva_handhold/directional/north,
/obj/item/tether_anchor{
	anchored = 1
	},
/turf/closed/wall/mineral/titanium/nodiagonal,
/area/shuttle/personally_bought/do_it_yourself_large)
"lf" = (
/obj/effect/turf_decal/delivery/white,
/obj/machinery/door/airlock/external,
/obj/effect/mapping_helpers/airlock/cyclelink_helper{
	dir = 1
	},
/obj/structure/fans/tiny,
/turf/open/floor/iron/dark/smooth_large,
/area/shuttle/personally_bought/do_it_yourself_large)
"lk" = (
/obj/structure/cable,
/obj/machinery/atmospherics/pipe/smart/manifold4w/supply/hidden/layer4,
/obj/machinery/atmospherics/pipe/smart/manifold4w/scrubbers/hidden/layer2,
/obj/effect/turf_decal/delivery/white,
/obj/machinery/door/airlock/hatch,
/turf/open/floor/iron/dark/smooth_large,
/area/shuttle/personally_bought/do_it_yourself_large)
"mb" = (
/obj/structure/marker_beacon/burgundy,
/turf/closed/wall/mineral/plastitanium,
/area/shuttle/personally_bought/do_it_yourself_large)
"mY" = (
/obj/machinery/atmospherics/components/unary/vent_scrubber/on/layer2{
	dir = 4
	},
/turf/open/floor/plating,
/area/shuttle/personally_bought/do_it_yourself_large)
"nD" = (
/obj/machinery/computer/camera_advanced/shuttle_docker/personally_bought{
	x_offset = -5;
	y_offset = -5;
	view_range = 4
	},
/obj/effect/turf_decal/bot_white,
/turf/open/floor/iron/dark/smooth_large,
/area/shuttle/personally_bought/do_it_yourself_large)
"nJ" = (
/obj/structure/cable,
/obj/machinery/atmospherics/components/unary/vent_pump/on/layer4{
	dir = 8
	},
/turf/open/floor/plating,
/area/shuttle/personally_bought/do_it_yourself_large)
"oA" = (
/obj/machinery/atmospherics/pipe/smart/manifold4w/supply/hidden/layer4,
/obj/machinery/atmospherics/pipe/smart/manifold4w/scrubbers/hidden/layer2,
/turf/open/floor/iron/smooth_large,
/area/shuttle/personally_bought/do_it_yourself_large)
"pq" = (
/obj/machinery/atmospherics/pipe/smart/manifold4w/supply/hidden/layer4,
/obj/machinery/atmospherics/pipe/smart/manifold4w/scrubbers/hidden/layer2,
/turf/open/floor/catwalk_floor/iron_dark,
/area/shuttle/personally_bought/do_it_yourself_large)
"ql" = (
/obj/machinery/portable_atmospherics/canister,
/obj/machinery/atmospherics/components/unary/portables_connector/visible/layer2{
	dir = 4
	},
/obj/effect/turf_decal/bot_white,
/turf/open/floor/iron/dark/smooth_large,
/area/shuttle/personally_bought/do_it_yourself_large)
"rf" = (
/obj/structure/table/reinforced,
/obj/machinery/recharger,
/obj/machinery/light/warm/directional/south,
/turf/open/floor/iron/dark/smooth_large,
/area/shuttle/personally_bought/do_it_yourself_large)
"rq" = (
/obj/structure/cable,
/obj/machinery/atmospherics/components/unary/vent_scrubber/on/layer2{
	dir = 8
	},
/turf/open/floor/plating,
/area/shuttle/personally_bought/do_it_yourself_large)
"sn" = (
/obj/structure/marker_beacon/bronze,
/turf/closed/wall/mineral/titanium,
/area/shuttle/personally_bought/do_it_yourself_large)
"sI" = (
/obj/machinery/portable_atmospherics/canister/oxygen,
/obj/machinery/atmospherics/components/unary/vent_scrubber/on/layer2{
	dir = 4
	},
/obj/effect/turf_decal/bot_white,
/obj/machinery/light/red/dim/directional/west,
/turf/open/floor/iron/dark/smooth_large,
/area/shuttle/personally_bought/do_it_yourself_large)
"tC" = (
/obj/machinery/atmospherics/components/unary/vent_pump/on/layer4{
	dir = 8
	},
/obj/structure/extinguisher_cabinet/directional/east,
/turf/open/floor/iron/smooth_large,
/area/shuttle/personally_bought/do_it_yourself_large)
"tF" = (
/obj/effect/turf_decal/bot_red,
/obj/machinery/holopad,
/obj/structure/cable,
/obj/machinery/button/door/personal_shuttle_windows/directional/north,
/turf/open/floor/iron/dark/smooth_large,
/area/shuttle/personally_bought/do_it_yourself_large)
"tO" = (
/obj/structure/extinguisher_cabinet/directional/east,
/obj/machinery/light/cold/directional/east,
/turf/open/floor/plating,
/area/shuttle/personally_bought/do_it_yourself_large)
"uw" = (
/obj/item/storage/toolbox/emergency,
/obj/item/binoculars,
/obj/item/trench_tool,
/obj/effect/turf_decal/bot_white,
/obj/structure/secure_safe/directional/north,
/obj/structure/extinguisher_cabinet/directional/west,
/obj/structure/shelf,
/turf/open/floor/iron/dark/smooth_large,
/area/shuttle/personally_bought/do_it_yourself_large)
"uF" = (
/obj/machinery/power/shuttle_engine/heater{
	dir = 8
	},
/obj/effect/turf_decal/stripes/line{
	dir = 4
	},
/obj/structure/window/reinforced/plasma/spawner/directional/east,
/turf/open/floor/plating/airless,
/area/shuttle/personally_bought/do_it_yourself_large)
"uT" = (
/obj/structure/marker_beacon/olive,
/turf/closed/wall/mineral/titanium/nodiagonal,
/area/shuttle/personally_bought/do_it_yourself_large)
"xh" = (
/obj/machinery/atmospherics/pipe/smart/manifold4w/supply/hidden/layer4,
/obj/machinery/atmospherics/pipe/smart/manifold4w/scrubbers/hidden/layer2,
/obj/effect/turf_decal/delivery/white,
/obj/machinery/door/airlock/external,
/obj/effect/mapping_helpers/airlock/cyclelink_helper,
/turf/open/floor/iron/dark/smooth_large,
/area/shuttle/personally_bought/do_it_yourself_large)
"xW" = (
/turf/template_noop,
/area/template_noop)
"yx" = (
/obj/machinery/computer/shuttle/personally_bought,
/obj/effect/turf_decal/bot_white,
/turf/open/floor/iron/dark/smooth_large,
/area/shuttle/personally_bought/do_it_yourself_large)
"yK" = (
/obj/structure/cable,
/obj/machinery/atmospherics/pipe/smart/manifold4w/scrubbers/hidden/layer2,
/obj/machinery/atmospherics/components/unary/vent_pump/on/layer4{
	dir = 8
	},
/turf/open/floor/iron/smooth_large,
/area/shuttle/personally_bought/do_it_yourself_large)
"za" = (
/obj/machinery/button/door/personal_shuttle_bay_one/directional/north,
/obj/structure/extinguisher_cabinet/directional/west,
/turf/open/floor/plating,
/area/shuttle/personally_bought/do_it_yourself_large)
"zo" = (
/obj/effect/spawner/structure/window/reinforced/shuttle,
/obj/structure/cable,
/obj/machinery/door/poddoor/preopen/personal_shuttle_windows,
/turf/open/floor/plating,
/area/shuttle/personally_bought/do_it_yourself_large)
"zH" = (
/obj/machinery/button/door/personal_shuttle_bay_one/directional/north,
/turf/open/floor/plating,
/area/shuttle/personally_bought/do_it_yourself_large)
"zJ" = (
/obj/machinery/power/apc/auto_name/directional/west,
/obj/structure/cable,
/obj/effect/mapping_helpers/apc/unlocked,
/obj/effect/mapping_helpers/apc/cell_10k,
/turf/open/floor/plating,
/area/shuttle/personally_bought/do_it_yourself_large)
"Ae" = (
/obj/structure/railing/eva_handhold/directional/north,
/turf/closed/wall/mineral/titanium/nodiagonal,
/area/shuttle/personally_bought/do_it_yourself_large)
"AW" = (
/obj/machinery/digital_clock/directional/south,
/turf/open/floor/plating,
/area/shuttle/personally_bought/do_it_yourself_large)
"Bb" = (
/obj/machinery/atmospherics/pipe/smart/manifold4w/scrubbers/hidden/layer2,
/obj/machinery/atmospherics/components/unary/vent_pump/on/layer4{
	dir = 4
	},
/turf/open/floor/iron/smooth_large,
/area/shuttle/personally_bought/do_it_yourself_large)
"Bh" = (
/obj/machinery/button/door/personal_shuttle_bay_one/directional/north,
/obj/machinery/light/cold/directional/east,
/turf/open/floor/plating,
/area/shuttle/personally_bought/do_it_yourself_large)
"Bu" = (
/obj/structure/cable,
/obj/machinery/atmospherics/pipe/smart/manifold4w/supply/hidden/layer4,
/obj/machinery/atmospherics/pipe/smart/manifold4w/scrubbers/hidden/layer2,
/turf/open/floor/plating,
/area/shuttle/personally_bought/do_it_yourself_large)
"CL" = (
/obj/machinery/atmospherics/pipe/smart/manifold4w/supply/hidden/layer4,
/obj/machinery/atmospherics/pipe/smart/manifold4w/scrubbers/hidden/layer2,
/obj/effect/turf_decal/delivery/white,
/obj/machinery/door/airlock/hatch,
/obj/structure/cable,
/turf/open/floor/iron/dark/smooth_large,
/area/shuttle/personally_bought/do_it_yourself_large)
"DJ" = (
/obj/item/tether_anchor{
	anchored = 1
	},
/turf/closed/wall/mineral/titanium/nodiagonal,
/area/shuttle/personally_bought/do_it_yourself_large)
"Eg" = (
/obj/machinery/atmospherics/pipe/smart/manifold4w/supply/hidden/layer4,
/obj/machinery/atmospherics/pipe/smart/manifold4w/scrubbers/hidden/layer2,
/obj/structure/cable,
/turf/open/floor/plating,
/area/shuttle/personally_bought/do_it_yourself_large)
"Er" = (
/obj/structure/closet/crate/cardboard/mothic,
/obj/item/construction/rtd/loaded{
	pixel_y = 7
	},
/obj/item/airlock_painter/decal,
/obj/item/airlock_painter{
	pixel_y = -7
	},
/obj/item/rcd_ammo,
/obj/item/rcd_ammo,
/obj/item/rcd_ammo,
/turf/open/floor/plating,
/area/shuttle/personally_bought/do_it_yourself_large)
"EY" = (
/obj/machinery/recharge_station,
/obj/machinery/atmospherics/components/unary/vent_scrubber/on/layer2,
/obj/effect/turf_decal/bot_white,
/turf/open/floor/iron/dark/smooth_large,
/area/shuttle/personally_bought/do_it_yourself_large)
"Fu" = (
/obj/machinery/atmospherics/components/unary/vent_pump/on/layer4{
	dir = 4
	},
/obj/machinery/light/cold/directional/west,
/turf/open/floor/plating,
/area/shuttle/personally_bought/do_it_yourself_large)
"FM" = (
/obj/effect/turf_decal/delivery,
/obj/machinery/door/poddoor/preopen/personal_bay_one,
/obj/structure/holosign/barrier/atmos/sturdy,
/turf/open/floor/iron/dark/smooth_large,
/area/shuttle/personally_bought/do_it_yourself_large)
"FY" = (
/obj/effect/turf_decal/delivery,
/obj/structure/holosign/barrier/atmos/sturdy,
/obj/machinery/door/poddoor/preopen/personal_bay_two,
/turf/open/floor/iron/dark/smooth_large,
/area/shuttle/personally_bought/do_it_yourself_large)
"Gs" = (
/obj/machinery/atmospherics/components/unary/vent_pump/on/layer4{
	dir = 1
	},
/turf/open/floor/plating,
/area/shuttle/personally_bought/do_it_yourself_large)
"GD" = (
/obj/structure/railing/eva_handhold/directional/south,
/turf/closed/wall/mineral/titanium/nodiagonal,
/area/shuttle/personally_bought/do_it_yourself_large)
"HK" = (
/turf/closed/wall/mineral/titanium,
/area/shuttle/personally_bought/do_it_yourself_large)
"HS" = (
/obj/machinery/portable_atmospherics/canister/air,
/obj/machinery/atmospherics/components/unary/portables_connector/visible/layer4{
	dir = 4
	},
/obj/effect/turf_decal/bot_white,
/turf/open/floor/iron/dark/smooth_large,
/area/shuttle/personally_bought/do_it_yourself_large)
"Iu" = (
/obj/machinery/atmospherics/components/unary/vent_scrubber/on/layer2,
/obj/machinery/suit_storage_unit/industrial/personal_shuttle,
/obj/effect/turf_decal/bot_white,
/obj/structure/extinguisher_cabinet/directional/north,
/obj/machinery/light/cold/directional/north,
/turf/open/floor/iron/dark/smooth_large,
/area/shuttle/personally_bought/do_it_yourself_large)
"Kh" = (
/obj/effect/turf_decal/delivery/white,
/obj/machinery/door/airlock/external,
/obj/effect/mapping_helpers/airlock/cyclelink_helper,
/obj/docking_port/mobile/personally_bought{
	dir = 2;
	port_direction = 8
	},
/obj/structure/fans/tiny,
/turf/open/floor/iron/dark/smooth_large,
/area/shuttle/personally_bought/do_it_yourself_large)
"Ln" = (
/obj/structure/closet/firecloset/shuttle,
/obj/effect/turf_decal/bot_white,
/turf/open/floor/iron/dark/smooth_large,
/area/shuttle/personally_bought/do_it_yourself_large)
"Lw" = (
/obj/machinery/atmospherics/components/unary/vent_pump/on/layer4{
	dir = 4
	},
/turf/open/floor/plating,
/area/shuttle/personally_bought/do_it_yourself_large)
"Ma" = (
/obj/structure/cable,
/turf/open/floor/plating,
/area/shuttle/personally_bought/do_it_yourself_large)
"Mo" = (
/turf/open/floor/plating,
/area/shuttle/personally_bought/do_it_yourself_large)
"MV" = (
/obj/effect/spawner/structure/window/reinforced/shuttle,
/obj/machinery/door/poddoor/preopen/personal_shuttle_windows,
/obj/structure/cable,
/turf/open/floor/plating,
/area/shuttle/personally_bought/do_it_yourself_large)
"Ov" = (
/obj/machinery/recharge_station,
/obj/effect/turf_decal/bot_white,
/turf/open/floor/iron/dark/smooth_large,
/area/shuttle/personally_bought/do_it_yourself_large)
"OO" = (
/obj/machinery/airalarm/directional/east,
/obj/effect/mapping_helpers/airalarm/all_access,
/turf/open/floor/plating,
/area/shuttle/personally_bought/do_it_yourself_large)
"OZ" = (
/obj/structure/cable,
/obj/machinery/atmospherics/pipe/smart/manifold4w/supply/hidden/layer4,
/obj/machinery/atmospherics/pipe/smart/manifold4w/scrubbers/hidden/layer2,
/obj/machinery/airalarm/directional/east,
/obj/effect/mapping_helpers/airalarm/all_access,
/obj/machinery/light/cold/directional/east,
/obj/effect/landmark/ship_captain_spawner,
/turf/open/floor/plating,
/area/shuttle/personally_bought/do_it_yourself_large)
"PD" = (
/obj/structure/extinguisher_cabinet/directional/east,
/turf/open/floor/plating,
/area/shuttle/personally_bought/do_it_yourself_large)
"PG" = (
/obj/machinery/airalarm/directional/west,
/obj/effect/mapping_helpers/airalarm/all_access,
/turf/open/floor/plating,
/area/shuttle/personally_bought/do_it_yourself_large)
"PH" = (
/obj/machinery/button/door/personal_shuttle_bay_two/directional/south,
/turf/open/floor/plating,
/area/shuttle/personally_bought/do_it_yourself_large)
"PT" = (
/obj/machinery/button/door/personal_shuttle_bay_two/directional/south,
/obj/machinery/light/cold/directional/east,
/turf/open/floor/plating,
/area/shuttle/personally_bought/do_it_yourself_large)
"Ra" = (
/obj/machinery/atmospherics/pipe/smart/manifold4w/supply/hidden/layer4,
/obj/machinery/atmospherics/pipe/smart/manifold4w/scrubbers/hidden/layer2,
/turf/open/floor/plating,
/area/shuttle/personally_bought/do_it_yourself_large)
"Sc" = (
/obj/effect/turf_decal/delivery/white,
/obj/machinery/door/airlock/external,
/obj/effect/mapping_helpers/airlock/cyclelink_helper{
	dir = 1
	},
/obj/machinery/atmospherics/pipe/smart/manifold4w/supply/hidden/layer4,
/turf/open/floor/iron/dark/smooth_large,
/area/shuttle/personally_bought/do_it_yourself_large)
"SU" = (
/obj/structure/marker_beacon/burgundy,
/turf/closed/wall/mineral/titanium,
/area/shuttle/personally_bought/do_it_yourself_large)
"TM" = (
/obj/effect/spawner/structure/window/reinforced/shuttle,
/obj/machinery/door/poddoor/preopen/personal_shuttle_windows,
/obj/structure/cable,
/obj/structure/railing/eva_handhold/directional/north,
/turf/open/floor/plating,
/area/shuttle/personally_bought/do_it_yourself_large)
"Ur" = (
/obj/structure/marker_beacon/olive,
/turf/closed/wall/mineral/plastitanium,
/area/shuttle/personally_bought/do_it_yourself_large)
"UK" = (
/turf/closed/wall/mineral/plastitanium/nodiagonal,
/area/shuttle/personally_bought/do_it_yourself_large)
"VF" = (
/obj/item/radio/intercom/directional/south,
/obj/structure/chair/comfy/shuttle{
	dir = 1
	},
/obj/structure/cable,
/turf/open/floor/iron/smooth_large,
/area/shuttle/personally_bought/do_it_yourself_large)
"WO" = (
/obj/machinery/atmospherics/components/unary/vent_scrubber/on/layer2{
	dir = 1
	},
/turf/open/floor/plating,
/area/shuttle/personally_bought/do_it_yourself_large)
"Yd" = (
/turf/closed/wall/mineral/titanium/nodiagonal,
/area/shuttle/personally_bought/do_it_yourself_large)
"YB" = (
/obj/machinery/digital_clock/directional/west,
/turf/open/floor/plating,
/area/shuttle/personally_bought/do_it_yourself_large)
"YG" = (
/obj/structure/cable,
/obj/structure/extinguisher_cabinet/directional/north,
/obj/machinery/light/cold/directional/north,
/turf/open/floor/plating,
/area/shuttle/personally_bought/do_it_yourself_large)
"Zu" = (
/obj/machinery/power/micro_reactor,
/obj/structure/cable,
/turf/open/floor/iron/dark/smooth_large,
/area/shuttle/personally_bought/do_it_yourself_large)
"ZL" = (
/obj/machinery/atmospherics/components/unary/vent_scrubber/on/layer2,
/turf/open/floor/plating,
/area/shuttle/personally_bought/do_it_yourself_large)

(1,1,1) = {"
xW
xW
xW
UK
hh
hh
hh
UK
xW
xW
xW
"}
(2,1,1) = {"
mb
hh
eL
UK
uF
uF
uF
UK
hh
hh
Ur
"}
(3,1,1) = {"
UK
uF
hJ
UK
Mo
Zu
Mo
UK
uF
uF
UK
"}
(4,1,1) = {"
UK
Ov
Bb
Yd
mY
Zu
Lw
Yd
ql
HS
UK
"}
(5,1,1) = {"
Yd
Iu
oA
lk
Ra
Bu
Ra
lk
oA
eo
Yd
"}
(6,1,1) = {"
kA
Yd
Yd
Yd
Mo
Bu
Mo
Yd
tC
Ln
GD
"}
(7,1,1) = {"
MV
Ma
PG
Yd
Yd
CL
Yd
Yd
Yd
Yd
DJ
"}
(8,1,1) = {"
Ae
YG
mY
Mo
Yd
Bu
Mo
zJ
Lw
Mo
GD
"}
(9,1,1) = {"
MV
Ma
Bu
Bu
CL
Bu
Bu
Eg
Ra
Mo
Yd
"}
(10,1,1) = {"
TM
Mo
nJ
Mo
Yd
Mo
Bu
tO
cv
Mo
GD
"}
(11,1,1) = {"
SU
Yd
MV
Yd
Yd
Yd
CL
Yd
Yd
Yd
je
"}
(12,1,1) = {"
xW
Yd
zH
ka
PG
YB
Bu
Mo
ew
Yd
xW
"}
(13,1,1) = {"
xW
FM
Mo
Mo
Mo
Mo
Bu
WO
Mo
FY
xW
"}
(14,1,1) = {"
xW
FM
Mo
bX
Bu
Bu
Bu
Gs
Mo
FY
xW
"}
(15,1,1) = {"
xW
FM
Mo
ZL
Bu
Mo
Ma
Mo
Mo
FY
xW
"}
(16,1,1) = {"
xW
Yd
Bh
Er
Bu
PD
Ma
Mo
PT
Yd
xW
"}
(17,1,1) = {"
SU
Yd
Yd
Yd
CL
Yd
MV
MV
Yd
Yd
je
"}
(18,1,1) = {"
Ae
sI
Yd
za
Bu
Lw
mY
PH
Yd
sI
GD
"}
(19,1,1) = {"
Kh
pq
Sc
Bu
Bu
OZ
Bu
Ra
xh
pq
lf
"}
(20,1,1) = {"
Ae
Yd
Yd
lk
Yd
Yd
lk
Yd
Yd
Yd
GD
"}
(21,1,1) = {"
Yd
cL
Fu
Bu
Yd
Mo
Bu
ka
Lw
Mo
DJ
"}
(22,1,1) = {"
Ae
EY
Bu
Bu
lk
Bu
Bu
Ra
Ra
AW
GD
"}
(23,1,1) = {"
DJ
Yd
lk
Yd
Yd
jT
Ma
Ma
rq
Ma
MV
"}
(24,1,1) = {"
Ae
uw
yK
cu
Yd
Mo
Mo
OO
Mo
Mo
GD
"}
(25,1,1) = {"
zo
nD
fm
rf
Yd
Yd
DJ
Yd
Yd
Yd
Yd
"}
(26,1,1) = {"
zo
yx
VF
Yd
HK
xW
xW
xW
xW
Yd
DJ
"}
(27,1,1) = {"
SU
Yd
tF
zo
xW
xW
xW
xW
xW
sn
uT
"}
(28,1,1) = {"
xW
HK
zo
Yd
xW
xW
xW
xW
xW
xW
xW
"}
