//MAP CONVERTED BY dmm2tgm.py THIS HEADER COMMENT PREVENTS RECONVERSION, DO NOT REMOVE
"a" = (
/obj/machinery/door/airlock/external/ruin,
/obj/structure/fans/tiny,
/turf/open/floor/plating/nanocarbon,
/area/shuttle/transport)
"e" = (
/obj/structure/closet/crate,
/obj/item/storage/toolbox/guncase/modular/munin,
/obj/item/storage/belt/military/pouches/sindaryo,
/obj/item/storage/belt/military/pouches/sindaryo,
/obj/item/storage/belt/military/pouches/sindaryo,
/obj/item/storage/belt/military/pouches/sindaryo,
/obj/item/storage/belt/military/pouches/sindaryo,
/obj/item/storage/belt/military/pouches/sindaryo,
/turf/open/floor/plating/aluminum,
/area/shuttle/transport)
"g" = (
/obj/effect/spawner/structure/window/reinforced/shuttle,
/turf/open/floor/plating,
/area/shuttle/transport)
"j" = (
/obj/machinery/power/shuttle_engine/propulsion{
	dir = 8
	},
/turf/open/floor/plating/nanocarbon/exterior/standard,
/area/shuttle/transport)
"k" = (
/obj/structure/table/reinforced,
/obj/item/storage/belt/utility/full/powertools/rcd,
/obj/item/storage/belt/utility/full/powertools/rcd{
	pixel_y = 3;
	pixel_x = 3
	},
/obj/item/storage/belt/utility/full/powertools/rcd{
	pixel_y = 3;
	pixel_x = -3
	},
/obj/item/storage/belt/utility/full/powertools/rcd{
	pixel_y = 8;
	pixel_x = 3
	},
/obj/item/storage/belt/utility/full/powertools/rcd{
	pixel_y = 6;
	pixel_x = -1
	},
/turf/open/floor/pod/dark,
/area/shuttle/transport)
"m" = (
/obj/structure/chair/comfy/shuttle{
	dir = 1
	},
/obj/effect/landmark/ert_shuttle_spawn,
/turf/open/floor/pod/dark,
/area/shuttle/transport)
"n" = (
/obj/machinery/door/airlock/titanium,
/turf/open/floor/plating/nanocarbon,
/area/shuttle/transport)
"s" = (
/obj/machinery/power/shuttle_engine/propulsion/right{
	dir = 8
	},
/turf/open/floor/plating/nanocarbon/exterior/standard,
/area/shuttle/transport)
"t" = (
/obj/structure/chair/comfy/shuttle,
/obj/machinery/light/directional/north,
/obj/effect/landmark/ert_shuttle_spawn,
/turf/open/floor/pod/dark,
/area/shuttle/transport)
"u" = (
/obj/machinery/light/directional/north,
/obj/structure/table/optable,
/obj/item/surgical_drapes,
/turf/open/floor/pod/dark,
/area/shuttle/transport)
"w" = (
/obj/machinery/computer/shuttle/ferry/request{
	dir = 8
	},
/turf/open/floor/pod/dark,
/area/shuttle/transport)
"x" = (
/obj/effect/landmark/ert_shuttle_brief_spawn,
/turf/open/floor/pod/light,
/area/shuttle/transport)
"A" = (
/obj/structure/shelf,
/obj/item/stack/sheet/iron/fifty{
	pixel_x = -4;
	pixel_y = 5
	},
/obj/item/stack/sheet/iron/fifty{
	pixel_x = -3;
	pixel_y = 2
	},
/obj/item/stack/sheet/rglass/fifty{
	pixel_x = -2;
	pixel_y = -1
	},
/obj/item/rcd_ammo/large{
	pixel_y = -6;
	pixel_x = 7
	},
/obj/item/rcd_ammo/large{
	pixel_y = -4;
	pixel_x = 7
	},
/obj/item/rcd_ammo/large{
	pixel_y = -2;
	pixel_x = 7
	},
/obj/item/rcd_ammo/large{
	pixel_x = 7
	},
/obj/item/rcd_ammo/large{
	pixel_x = 7;
	pixel_y = 2
	},
/turf/open/floor/pod/dark,
/area/shuttle/transport)
"B" = (
/obj/machinery/power/shuttle_engine/heater{
	dir = 8
	},
/turf/closed/wall/mineral/titanium,
/area/shuttle/transport)
"E" = (
/obj/structure/table/reinforced,
/obj/effect/spawner/surgery_tray/full,
/turf/open/floor/pod/dark,
/area/shuttle/transport)
"G" = (
/turf/closed/wall/mineral/titanium,
/area/shuttle/transport)
"H" = (
/obj/structure/shelf,
/obj/machinery/light/small/directional/east,
/obj/item/storage/hypospraykit/cmo/combat{
	pixel_y = 6
	},
/obj/item/gun/medbeam{
	pixel_y = -7
	},
/turf/open/floor/plating/aluminum,
/area/shuttle/transport)
"K" = (
/obj/machinery/power/shuttle_engine/propulsion/left{
	dir = 8
	},
/turf/open/floor/plating/nanocarbon/exterior/standard,
/area/shuttle/transport)
"L" = (
/obj/structure/guncase/wt550{
	capacity = 6
	},
/turf/open/floor/plating/aluminum,
/area/shuttle/transport)
"M" = (
/obj/machinery/light/directional/south,
/obj/structure/closet/secure_closet/engineering_electrical,
/obj/item/grenade/c4{
	pixel_x = 3;
	pixel_y = 1
	},
/obj/item/grenade/c4{
	pixel_x = 3;
	pixel_y = 1
	},
/obj/item/grenade/c4{
	pixel_x = 3;
	pixel_y = 1
	},
/turf/open/floor/pod/dark,
/area/shuttle/transport)
"O" = (
/obj/machinery/light/small/directional/east,
/obj/structure/shelf,
/obj/item/clothing/suit/armor/vest/combatarmor{
	pixel_x = -4;
	pixel_y = -7
	},
/obj/item/clothing/suit/armor/vest/combatarmor{
	pixel_x = -4;
	pixel_y = -7
	},
/obj/item/clothing/suit/armor/vest/combatarmor{
	pixel_y = -7;
	pixel_x = 1
	},
/obj/item/clothing/suit/armor/vest/combatarmor{
	pixel_y = -7;
	pixel_x = 1
	},
/obj/item/clothing/suit/armor/vest/combatarmor{
	pixel_y = -7;
	pixel_x = 6
	},
/obj/item/clothing/suit/armor/vest/combatarmor{
	pixel_y = -7;
	pixel_x = 6
	},
/obj/item/clothing/head/helmet/pressurehelmet{
	pixel_x = -4;
	pixel_y = 4
	},
/obj/item/clothing/head/helmet/pressurehelmet{
	pixel_x = -4;
	pixel_y = 4
	},
/obj/item/clothing/head/helmet/pressurehelmet{
	pixel_x = 1;
	pixel_y = 4
	},
/obj/item/clothing/head/helmet/pressurehelmet{
	pixel_x = 1;
	pixel_y = 4
	},
/obj/item/clothing/head/helmet/pressurehelmet{
	pixel_x = 6;
	pixel_y = 4
	},
/obj/item/clothing/head/helmet/pressurehelmet{
	pixel_x = 6;
	pixel_y = 4
	},
/turf/open/floor/plating/aluminum,
/area/shuttle/transport)
"R" = (
/obj/machinery/door/airlock/titanium,
/obj/docking_port/mobile{
	dir = 8;
	shuttle_id = "ferry";
	name = "ferry shuttle";
	preferred_direction = 4
	},
/obj/structure/fans/tiny,
/turf/open/floor/plating/nanocarbon,
/area/shuttle/transport)
"T" = (
/obj/structure/chair/comfy/shuttle,
/obj/effect/landmark/ert_shuttle_spawn,
/turf/open/floor/pod/dark,
/area/shuttle/transport)
"U" = (
/obj/structure/chair/comfy/shuttle{
	dir = 4
	},
/obj/machinery/light/directional/south,
/obj/effect/landmark/ert_shuttle_spawn,
/turf/open/floor/pod/dark,
/area/shuttle/transport)
"W" = (
/turf/open/floor/pod/light,
/area/shuttle/transport)
"Y" = (
/obj/structure/shelf,
/obj/item/storage/medkit/brute{
	pixel_y = -3
	},
/obj/item/storage/medkit/fire{
	pixel_y = 1
	},
/obj/item/storage/medkit/advanced{
	pixel_y = 6
	},
/turf/open/floor/pod/dark,
/area/shuttle/transport)
"Z" = (
/turf/open/floor/plating/nanocarbon,
/area/shuttle/transport)

(1,1,1) = {"
G
K
j
s
G
"}
(2,1,1) = {"
G
B
B
B
G
"}
(3,1,1) = {"
G
L
Z
e
G
"}
(4,1,1) = {"
G
O
Z
H
G
"}
(5,1,1) = {"
G
G
n
G
G
"}
(6,1,1) = {"
g
Y
W
A
g
"}
(7,1,1) = {"
G
u
W
M
G
"}
(8,1,1) = {"
G
E
W
k
G
"}
(9,1,1) = {"
a
W
x
W
a
"}
(10,1,1) = {"
G
T
W
m
G
"}
(11,1,1) = {"
G
t
W
U
G
"}
(12,1,1) = {"
g
T
W
w
g
"}
(13,1,1) = {"
G
g
R
g
G
"}
