//MAP CONVERTED BY dmm2tgm.py THIS HEADER COMMENT PREVENTS RECONVERSION, DO NOT REMOVE
"ae" = (
/obj/structure/chair/comfy/shuttle{
	dir = 1
	},
/turf/open/floor/iron/dark/smooth_large,
/area/shuttle/personally_bought/people_mover)
"ai" = (
/obj/machinery/modular_computer/preset/engineering{
	dir = 1
	},
/obj/structure/cable,
/obj/effect/turf_decal/bot_white,
/obj/machinery/suit_storage_unit/industrial/personal_shuttle,
/obj/machinery/button/door/personal_shuttle_windows/directional/north,
/turf/open/floor/iron/dark/smooth_large,
/area/shuttle/personally_bought/people_mover)
"aL" = (
/turf/closed/wall/mineral/plastitanium,
/area/shuttle/personally_bought/people_mover)
"co" = (
/obj/machinery/computer/camera_advanced/shuttle_docker/personally_bought{
	view_range = 2;
	y_offset = 5
	},
/obj/effect/turf_decal/bot_white,
/turf/open/floor/iron/dark/smooth_large,
/area/shuttle/personally_bought/people_mover)
"dh" = (
/obj/machinery/atmospherics/pipe/smart/manifold4w/supply/hidden/layer4,
/obj/machinery/atmospherics/pipe/smart/manifold4w/scrubbers/hidden/layer2,
/turf/open/floor/catwalk_floor/iron_dark,
/area/shuttle/personally_bought/people_mover)
"dR" = (
/obj/machinery/atmospherics/pipe/smart/manifold4w/scrubbers/hidden/layer2,
/obj/machinery/atmospherics/pipe/smart/manifold4w/supply/hidden/layer4,
/obj/structure/cable,
/obj/machinery/power/micro_reactor,
/obj/effect/landmark/ship_captain_spawner,
/turf/open/floor/iron/dark/smooth_large,
/area/shuttle/personally_bought/people_mover)
"gV" = (
/obj/machinery/atmospherics/pipe/smart/manifold4w/scrubbers/hidden/layer2,
/obj/machinery/atmospherics/pipe/smart/manifold4w/supply/hidden/layer4,
/obj/structure/cable,
/turf/open/floor/iron/smooth,
/area/shuttle/personally_bought/people_mover)
"hR" = (
/obj/structure/railing/eva_handhold/directional/south,
/turf/closed/wall/mineral/plastitanium/nodiagonal,
/area/shuttle/personally_bought/people_mover)
"ie" = (
/obj/effect/turf_decal/stripes/line{
	dir = 4
	},
/obj/machinery/power/shuttle_engine/heater{
	dir = 8
	},
/obj/structure/window/reinforced/plasma/spawner/directional/east,
/turf/open/floor/plating/airless,
/area/shuttle/personally_bought/people_mover)
"iJ" = (
/obj/machinery/portable_atmospherics/canister/oxygen,
/obj/machinery/atmospherics/components/unary/vent_scrubber/on/layer2{
	dir = 4
	},
/obj/effect/turf_decal/bot_white,
/obj/machinery/light/red/dim/directional/west,
/turf/open/floor/iron/dark/smooth_large,
/area/shuttle/personally_bought/people_mover)
"iX" = (
/obj/item/tether_anchor{
	anchored = 1
	},
/turf/closed/wall/mineral/plastitanium/nodiagonal,
/area/shuttle/personally_bought/people_mover)
"jx" = (
/obj/structure/marker_beacon/olive,
/turf/closed/wall/mineral/titanium,
/area/shuttle/personally_bought/people_mover)
"jM" = (
/obj/effect/turf_decal/bot_white,
/obj/machinery/atmospherics/components/unary/portables_connector/visible/layer2{
	dir = 4
	},
/obj/machinery/portable_atmospherics/canister,
/turf/open/floor/iron/dark/smooth_large,
/area/shuttle/personally_bought/people_mover)
"mf" = (
/obj/structure/marker_beacon/burgundy,
/turf/closed/wall/mineral/plastitanium,
/area/shuttle/personally_bought/people_mover)
"nC" = (
/obj/effect/turf_decal/bot_white,
/obj/machinery/atmospherics/components/unary/vent_pump/on/layer4{
	dir = 8
	},
/obj/structure/extinguisher_cabinet/directional/south,
/obj/structure/closet/firecloset/shuttle/tools,
/turf/open/floor/iron/dark/smooth_large,
/area/shuttle/personally_bought/people_mover)
"or" = (
/obj/structure/shelf,
/obj/effect/spawner/random/maintenance/no_decals,
/obj/effect/turf_decal/bot_white,
/turf/open/floor/iron/dark/smooth_large,
/area/shuttle/personally_bought/people_mover)
"ow" = (
/obj/item/storage/toolbox/emergency,
/obj/item/binoculars,
/obj/item/trench_tool,
/obj/effect/turf_decal/bot_white,
/obj/machinery/light/warm/directional/south,
/obj/structure/shelf,
/turf/open/floor/iron/dark/smooth_large,
/area/shuttle/personally_bought/people_mover)
"oI" = (
/obj/item/tether_anchor{
	anchored = 1
	},
/turf/closed/wall/mineral/titanium/nodiagonal,
/area/shuttle/personally_bought/people_mover)
"pf" = (
/obj/effect/turf_decal/delivery/white,
/obj/machinery/door/airlock/external,
/obj/effect/mapping_helpers/airlock/cyclelink_helper{
	dir = 1
	},
/obj/docking_port/mobile/personally_bought,
/obj/structure/fans/tiny,
/turf/open/floor/iron/dark/smooth_large,
/area/shuttle/personally_bought/people_mover)
"pg" = (
/obj/machinery/button/door/personal_shuttle_windows/directional/east,
/obj/machinery/atmospherics/components/unary/vent_pump/on/layer4{
	dir = 8
	},
/obj/structure/chair/comfy/shuttle{
	dir = 8
	},
/turf/open/floor/iron/dark/smooth_large,
/area/shuttle/personally_bought/people_mover)
"pl" = (
/obj/structure/shelf,
/obj/effect/spawner/random/maintenance/no_decals/three,
/obj/effect/turf_decal/bot_white,
/turf/open/floor/iron/dark/smooth_large,
/area/shuttle/personally_bought/people_mover)
"pM" = (
/obj/structure/cable,
/obj/machinery/atmospherics/pipe/smart/manifold4w/supply/hidden/layer4,
/obj/machinery/atmospherics/pipe/smart/manifold4w/scrubbers/hidden/layer2,
/turf/open/floor/iron/smooth,
/area/shuttle/personally_bought/people_mover)
"pV" = (
/obj/structure/cable,
/obj/machinery/atmospherics/components/unary/vent_pump/on/layer4{
	dir = 4
	},
/turf/open/floor/iron/smooth_large,
/area/shuttle/personally_bought/people_mover)
"qy" = (
/obj/structure/cable,
/obj/machinery/atmospherics/pipe/smart/manifold4w/supply/hidden/layer4,
/obj/machinery/atmospherics/pipe/smart/manifold4w/scrubbers/hidden/layer2,
/turf/open/floor/iron/smooth_large,
/area/shuttle/personally_bought/people_mover)
"sa" = (
/obj/structure/cable,
/obj/machinery/atmospherics/components/unary/vent_scrubber/on/layer2{
	dir = 8
	},
/turf/open/floor/iron/smooth_large,
/area/shuttle/personally_bought/people_mover)
"us" = (
/obj/machinery/atmospherics/pipe/smart/manifold4w/supply/hidden/layer4,
/obj/machinery/atmospherics/pipe/smart/manifold4w/scrubbers/hidden/layer2,
/obj/effect/turf_decal/delivery/white,
/obj/machinery/door/airlock/external,
/obj/effect/mapping_helpers/airlock/cyclelink_helper,
/turf/open/floor/iron/dark/smooth_large,
/area/shuttle/personally_bought/people_mover)
"ux" = (
/obj/structure/sign/calendar/directional/north,
/obj/structure/chair/comfy/shuttle,
/turf/open/floor/iron/dark/smooth_large,
/area/shuttle/personally_bought/people_mover)
"uy" = (
/obj/structure/marker_beacon/olive,
/turf/closed/wall/mineral/plastitanium,
/area/shuttle/personally_bought/people_mover)
"uI" = (
/obj/structure/marker_beacon/burgundy,
/turf/closed/wall/mineral/titanium/nodiagonal,
/area/shuttle/personally_bought/people_mover)
"vv" = (
/obj/machinery/light_switch/directional/north,
/obj/structure/shelf,
/obj/effect/turf_decal/bot_white,
/turf/open/floor/iron/dark/smooth_large,
/area/shuttle/personally_bought/people_mover)
"vU" = (
/obj/machinery/power/shuttle_engine/propulsion{
	dir = 8
	},
/obj/effect/turf_decal/stripes/line{
	dir = 8
	},
/turf/open/floor/plating/airless,
/area/shuttle/personally_bought/people_mover)
"xe" = (
/obj/machinery/atmospherics/components/unary/vent_scrubber/on/layer2{
	dir = 8
	},
/obj/structure/chair/comfy/shuttle{
	dir = 8
	},
/turf/open/floor/iron/dark/smooth_large,
/area/shuttle/personally_bought/people_mover)
"xj" = (
/obj/machinery/atmospherics/components/unary/vent_scrubber/on/layer2{
	dir = 4
	},
/obj/structure/closet/crate,
/obj/effect/spawner/random/maintenance/no_decals/four,
/obj/effect/turf_decal/bot_white,
/turf/open/floor/iron/dark/smooth_large,
/area/shuttle/personally_bought/people_mover)
"xz" = (
/obj/machinery/power/apc/auto_name/directional/west,
/obj/effect/mapping_helpers/apc/cell_5k,
/obj/effect/mapping_helpers/apc/unlocked,
/obj/structure/cable,
/obj/structure/closet/crate/preopen,
/obj/effect/turf_decal/bot_white,
/turf/open/floor/iron/dark/smooth_large,
/area/shuttle/personally_bought/people_mover)
"xN" = (
/obj/effect/spawner/structure/window/reinforced/shuttle,
/obj/structure/cable,
/obj/machinery/door/poddoor/preopen/personal_shuttle_windows,
/turf/open/floor/plating,
/area/shuttle/personally_bought/people_mover)
"zg" = (
/obj/machinery/atmospherics/pipe/smart/manifold4w/scrubbers/hidden/layer2,
/obj/machinery/atmospherics/pipe/smart/manifold4w/supply/hidden/layer4,
/obj/structure/cable,
/obj/machinery/airalarm/directional/east,
/obj/effect/mapping_helpers/airalarm/all_access,
/turf/open/floor/catwalk_floor/iron_smooth,
/area/shuttle/personally_bought/people_mover)
"Bq" = (
/obj/machinery/atmospherics/pipe/smart/manifold4w/scrubbers/hidden/layer2,
/obj/machinery/atmospherics/pipe/smart/manifold4w/supply/hidden/layer4,
/obj/machinery/light/cold/directional/south,
/turf/open/floor/iron/smooth_large,
/area/shuttle/personally_bought/people_mover)
"BK" = (
/obj/structure/railing/eva_handhold/directional/north,
/turf/closed/wall/mineral/plastitanium/nodiagonal,
/area/shuttle/personally_bought/people_mover)
"CB" = (
/obj/machinery/light/cold/directional/north,
/obj/machinery/digital_clock/directional/north,
/obj/machinery/atmospherics/components/unary/vent_pump/on/layer4,
/obj/structure/shelf,
/obj/effect/spawner/random/maintenance/no_decals/two,
/obj/effect/turf_decal/bot_white,
/turf/open/floor/iron/dark/smooth_large,
/area/shuttle/personally_bought/people_mover)
"Db" = (
/obj/machinery/computer/shuttle/personally_bought,
/obj/effect/turf_decal/bot_white,
/turf/open/floor/iron/dark/smooth_large,
/area/shuttle/personally_bought/people_mover)
"DE" = (
/obj/machinery/light/cold/directional/north,
/obj/structure/closet/crate/preopen,
/obj/effect/turf_decal/bot_white,
/turf/open/floor/iron/dark/smooth_large,
/area/shuttle/personally_bought/people_mover)
"Es" = (
/obj/structure/shelf,
/obj/effect/turf_decal/bot_white,
/turf/open/floor/iron/dark/smooth_large,
/area/shuttle/personally_bought/people_mover)
"EW" = (
/obj/machinery/atmospherics/pipe/smart/manifold4w/scrubbers/hidden/layer2,
/obj/structure/closet/firecloset/shuttle,
/obj/effect/turf_decal/bot_white,
/turf/open/floor/iron/dark/smooth_large,
/area/shuttle/personally_bought/people_mover)
"Fl" = (
/obj/structure/marker_beacon/olive,
/turf/closed/wall/mineral/titanium/nodiagonal,
/area/shuttle/personally_bought/people_mover)
"Fw" = (
/turf/closed/wall/mineral/titanium/nodiagonal,
/area/shuttle/personally_bought/people_mover)
"FC" = (
/turf/closed/wall/mineral/plastitanium/nodiagonal,
/area/shuttle/personally_bought/people_mover)
"Gc" = (
/obj/machinery/atmospherics/pipe/smart/manifold4w/scrubbers/hidden/layer2,
/obj/machinery/atmospherics/pipe/smart/manifold4w/supply/hidden/layer4,
/obj/machinery/meter/layer4,
/turf/open/floor/iron/smooth,
/area/shuttle/personally_bought/people_mover)
"Gg" = (
/obj/structure/chair/comfy/shuttle{
	dir = 1
	},
/obj/structure/cable,
/obj/item/radio/intercom/directional/north,
/turf/open/floor/iron/smooth_large,
/area/shuttle/personally_bought/people_mover)
"GF" = (
/obj/structure/closet/crate/robust,
/obj/effect/spawner/random/maintenance/no_decals/two,
/obj/effect/turf_decal/bot_white,
/turf/open/floor/iron/dark/smooth_large,
/area/shuttle/personally_bought/people_mover)
"GK" = (
/obj/machinery/atmospherics/pipe/smart/manifold4w/scrubbers/hidden/layer2,
/obj/machinery/atmospherics/pipe/smart/manifold4w/supply/hidden/layer4,
/obj/machinery/meter/layer2,
/turf/open/floor/iron/smooth,
/area/shuttle/personally_bought/people_mover)
"HJ" = (
/obj/machinery/power/shuttle_engine/propulsion{
	dir = 8
	},
/obj/machinery/atmospherics/components/unary/passive_vent/layer2{
	dir = 4
	},
/obj/effect/turf_decal/stripes/line{
	dir = 8
	},
/turf/open/floor/plating/airless,
/area/shuttle/personally_bought/people_mover)
"HL" = (
/obj/machinery/modular_computer/preset/engineering{
	dir = 1
	},
/obj/structure/cable,
/obj/effect/turf_decal/bot_white,
/obj/structure/extinguisher_cabinet/directional/west,
/turf/open/floor/iron/dark/smooth_large,
/area/shuttle/personally_bought/people_mover)
"HN" = (
/obj/machinery/atmospherics/pipe/smart/manifold4w/scrubbers/hidden/layer2,
/obj/machinery/atmospherics/pipe/smart/manifold4w/supply/hidden/layer4,
/obj/structure/cable,
/turf/open/floor/catwalk_floor/iron_smooth,
/area/shuttle/personally_bought/people_mover)
"Ix" = (
/obj/machinery/atmospherics/pipe/smart/manifold4w/scrubbers/hidden/layer2,
/obj/machinery/atmospherics/pipe/smart/manifold4w/supply/hidden/layer4,
/obj/machinery/light/cold/directional/north,
/turf/open/floor/iron/smooth_large,
/area/shuttle/personally_bought/people_mover)
"IA" = (
/obj/machinery/light/cold/directional/north,
/obj/structure/chair/comfy/shuttle,
/turf/open/floor/iron/dark/smooth_large,
/area/shuttle/personally_bought/people_mover)
"Ki" = (
/obj/machinery/atmospherics/components/unary/vent_pump/on/layer4{
	dir = 4
	},
/obj/machinery/recharge_station,
/obj/effect/turf_decal/bot_white,
/turf/open/floor/iron/dark/smooth_large,
/area/shuttle/personally_bought/people_mover)
"Lj" = (
/obj/structure/cable,
/obj/machinery/atmospherics/pipe/smart/manifold4w/scrubbers/hidden/layer2,
/obj/machinery/atmospherics/pipe/smart/manifold4w/supply/hidden/layer4,
/turf/open/floor/iron/smooth_large,
/area/shuttle/personally_bought/people_mover)
"Lt" = (
/obj/structure/railing/eva_handhold/directional/north,
/turf/closed/wall/mineral/titanium/nodiagonal,
/area/shuttle/personally_bought/people_mover)
"LJ" = (
/obj/effect/turf_decal/bot_red,
/obj/machinery/holopad,
/obj/structure/cable,
/turf/open/floor/iron/dark/smooth_large,
/area/shuttle/personally_bought/people_mover)
"MF" = (
/turf/closed/wall/mineral/titanium,
/area/shuttle/personally_bought/people_mover)
"MT" = (
/obj/structure/cable,
/obj/machinery/atmospherics/pipe/smart/manifold4w/supply/hidden/layer4,
/obj/machinery/atmospherics/pipe/smart/manifold4w/scrubbers/hidden/layer2,
/turf/open/floor/catwalk_floor/iron_smooth,
/area/shuttle/personally_bought/people_mover)
"NL" = (
/obj/structure/table/reinforced,
/obj/machinery/recharger,
/obj/structure/secure_safe/directional/north,
/turf/open/floor/iron/dark/smooth_large,
/area/shuttle/personally_bought/people_mover)
"Ok" = (
/obj/machinery/power/shuttle_engine/heater{
	dir = 8
	},
/obj/structure/window/reinforced/plasma/spawner/directional/east,
/obj/effect/turf_decal/stripes/line{
	dir = 4
	},
/turf/open/floor/plating/airless,
/area/shuttle/personally_bought/people_mover)
"Qc" = (
/obj/machinery/atmospherics/pipe/smart/manifold4w/supply/hidden/layer4,
/obj/machinery/atmospherics/pipe/smart/manifold4w/scrubbers/hidden/layer2,
/obj/structure/cable,
/turf/open/floor/catwalk_floor/iron_smooth,
/area/shuttle/personally_bought/people_mover)
"Qw" = (
/obj/machinery/atmospherics/pipe/smart/manifold4w/scrubbers/hidden/layer2,
/obj/machinery/atmospherics/pipe/smart/manifold4w/supply/hidden/layer4,
/turf/open/floor/iron/smooth,
/area/shuttle/personally_bought/people_mover)
"QF" = (
/obj/structure/railing/eva_handhold/directional/south,
/turf/closed/wall/mineral/titanium/nodiagonal,
/area/shuttle/personally_bought/people_mover)
"RY" = (
/obj/structure/marker_beacon/bronze,
/turf/closed/wall/mineral/titanium,
/area/shuttle/personally_bought/people_mover)
"Sd" = (
/obj/machinery/atmospherics/pipe/smart/manifold4w/supply/hidden/layer4,
/obj/effect/turf_decal/delivery/white,
/obj/machinery/door/airlock/hatch,
/obj/machinery/atmospherics/pipe/smart/manifold4w/scrubbers/hidden/layer2,
/turf/open/floor/iron/dark/smooth_large,
/area/shuttle/personally_bought/people_mover)
"Tw" = (
/turf/template_noop,
/area/template_noop)
"TM" = (
/obj/machinery/atmospherics/pipe/smart/manifold4w/scrubbers/hidden/layer2,
/obj/machinery/atmospherics/pipe/smart/manifold4w/supply/hidden/layer4,
/turf/open/floor/catwalk_floor/iron_smooth,
/area/shuttle/personally_bought/people_mover)
"Vh" = (
/obj/machinery/atmospherics/pipe/smart/manifold4w/supply/hidden/layer4,
/obj/effect/turf_decal/delivery/white,
/obj/machinery/door/airlock/hatch,
/obj/machinery/atmospherics/pipe/smart/manifold4w/scrubbers/hidden/layer2,
/obj/structure/cable,
/turf/open/floor/iron/dark/smooth_large,
/area/shuttle/personally_bought/people_mover)
"Wc" = (
/obj/machinery/power/shuttle_engine/heater{
	dir = 8
	},
/obj/structure/window/reinforced/plasma/spawner/directional/east,
/obj/machinery/atmospherics/pipe/smart/manifold4w/scrubbers/hidden/layer2,
/obj/effect/turf_decal/stripes/line{
	dir = 4
	},
/turf/open/floor/plating/airless,
/area/shuttle/personally_bought/people_mover)
"WP" = (
/obj/effect/turf_decal/bot_white,
/obj/machinery/atmospherics/components/unary/portables_connector/visible/layer4{
	dir = 8
	},
/obj/machinery/portable_atmospherics/canister/air,
/obj/structure/extinguisher_cabinet/directional/north,
/turf/open/floor/iron/dark/smooth_large,
/area/shuttle/personally_bought/people_mover)
"WY" = (
/obj/machinery/atmospherics/pipe/smart/manifold4w/supply/hidden/layer4,
/obj/machinery/atmospherics/pipe/smart/manifold4w/scrubbers/hidden/layer2,
/obj/effect/turf_decal/delivery/white,
/obj/machinery/door/airlock/hatch,
/turf/open/floor/iron/dark/smooth_large,
/area/shuttle/personally_bought/people_mover)

(1,1,1) = {"
mf
HJ
FC
Tw
Tw
Tw
FC
vU
uy
"}
(2,1,1) = {"
FC
Wc
FC
vU
vU
vU
FC
Ok
FC
"}
(3,1,1) = {"
BK
EW
FC
ie
ie
ie
FC
jM
hR
"}
(4,1,1) = {"
iX
Ix
Sd
GK
TM
Gc
WY
Bq
iX
"}
(5,1,1) = {"
aL
WP
FC
DE
dR
or
FC
nC
aL
"}
(6,1,1) = {"
uI
Fw
Fw
GF
gV
Es
Fw
Fw
Fl
"}
(7,1,1) = {"
Fw
vv
xz
xj
HN
Ki
Fw
iJ
QF
"}
(8,1,1) = {"
Lt
CB
gV
gV
zg
Qw
us
dh
pf
"}
(9,1,1) = {"
uI
Fw
Qc
ae
Fw
Fw
Fw
Fw
Fl
"}
(10,1,1) = {"
Fw
ux
MT
ae
Fw
ai
pV
HL
Fw
"}
(11,1,1) = {"
oI
IA
pM
pM
Vh
qy
Lj
ow
oI
"}
(12,1,1) = {"
Fw
pl
xe
pg
Fw
NL
sa
co
xN
"}
(13,1,1) = {"
Fw
Fw
xN
Fw
Fw
Fw
Gg
Db
xN
"}
(14,1,1) = {"
uI
RY
Tw
Tw
Tw
xN
LJ
Fw
jx
"}
(15,1,1) = {"
Tw
Tw
Tw
Tw
Tw
Fw
xN
MF
Tw
"}
