//MAP CONVERTED BY dmm2tgm.py THIS HEADER COMMENT PREVENTS RECONVERSION, DO NOT REMOVE
"bo" = (
/obj/structure/shuttle_decoration,
/turf/template_noop,
/area/template_noop)
"ce" = (
/obj/machinery/portable_atmospherics/canister/air,
/obj/machinery/power/apc/worn_out/directional/north,
/turf/open/floor/plating/nanocarbon,
/area/shuttle/salvaged_shuttle)
"cP" = (
/obj/machinery/exoscanner/shuttle_part/radar_panel/directional/south,
/turf/closed/wall/mineral/nanocarbon/black,
/area/shuttle/salvaged_shuttle)
"dD" = (
/obj/structure/railing/eva_handhold/directional/south,
/obj/structure/railing/eva_handhold/directional/north,
/obj/effect/mapping_helpers/salvage_anchor/five,
/obj/structure/marker_beacon/jade,
/turf/open/floor/engine/anchor_jack,
/area/shuttle/salvaged_shuttle)
"ez" = (
/turf/closed/wall/mineral/nanocarbon/yellow,
/area/shuttle/salvaged_shuttle)
"fI" = (
/obj/structure/marker_beacon/burgundy,
/turf/closed/wall/mineral/nanocarbon/yellow,
/area/shuttle/salvaged_shuttle)
"gM" = (
/obj/structure/shuttle_decoration/wall_plate/gold_foil,
/turf/closed/wall/mineral/aluminum,
/area/shuttle/salvaged_shuttle)
"ik" = (
/obj/structure/shuttle_decoration/wall_plate/gold_foil{
	dir = 8
	},
/turf/closed/wall/mineral/aluminum,
/area/shuttle/salvaged_shuttle)
"iy" = (
/obj/structure/shuttle_decoration/wall_plate/nanocarbon/yellow,
/turf/closed/wall/mineral/nanocarbon/yellow,
/area/shuttle/salvaged_shuttle)
"iA" = (
/obj/structure/shuttle_decoration/bullbar/directional/east,
/turf/closed/wall/mineral/nanocarbon/yellow,
/area/shuttle/salvaged_shuttle)
"jv" = (
/obj/effect/baseturf_helper/salvage_shuttle,
/obj/structure/shuttle_decoration/rcs/directional/north,
/turf/closed/wall/mineral/nanocarbon/black,
/area/shuttle/salvaged_shuttle)
"km" = (
/obj/machinery/exoscanner/shuttle_part/open_sensors_blister/directional/south,
/turf/template_noop,
/area/template_noop)
"kO" = (
/turf/open/floor/catwalk_floor/colony_fabricator,
/area/shuttle/salvaged_shuttle)
"kP" = (
/obj/machinery/exoscanner/shuttle_part/radar_panel/directional/north,
/turf/closed/wall/mineral/nanocarbon/black,
/area/shuttle/salvaged_shuttle)
"kZ" = (
/obj/structure/marker_beacon/burgundy,
/obj/structure/railing/eva_handhold/directional/south,
/turf/closed/wall/mineral/nanocarbon/nodiagonal/black,
/area/shuttle/salvaged_shuttle)
"ly" = (
/obj/structure/shuttle_decoration/wall_plate/gold_foil{
	dir = 4
	},
/turf/closed/wall/mineral/aluminum,
/area/shuttle/salvaged_shuttle)
"md" = (
/obj/structure/shuttle_decoration/radiator/directional/west,
/turf/closed/wall/mineral/nanocarbon/black,
/area/shuttle/salvaged_shuttle)
"mH" = (
/turf/open/floor/iron/colony,
/area/shuttle/salvaged_shuttle)
"nw" = (
/obj/machinery/power/shuttle_engine/heater{
	dir = 8
	},
/turf/open/floor/plating/nanocarbon,
/area/shuttle/salvaged_shuttle)
"nN" = (
/obj/structure/shuttle_decoration/wall_plate/gold_foil{
	dir = 1
	},
/turf/closed/wall/mineral/aluminum,
/area/shuttle/salvaged_shuttle)
"nP" = (
/obj/structure/mineral_door/manual_colony_door,
/turf/open/floor/iron/colony/texture,
/area/shuttle/salvaged_shuttle)
"oM" = (
/obj/structure/marker_beacon/jade,
/turf/closed/wall/mineral/nanocarbon/yellow,
/area/shuttle/salvaged_shuttle)
"pa" = (
/obj/structure/shuttle_decoration/wall_plate/nanocarbon/yellow{
	dir = 1
	},
/turf/closed/wall/mineral/nanocarbon/yellow,
/area/shuttle/salvaged_shuttle)
"pH" = (
/obj/machinery/light/cold/dim/directional/west,
/turf/open/floor/catwalk_floor/colony_fabricator,
/area/shuttle/salvaged_shuttle)
"rb" = (
/turf/open/floor/plating/aluminum,
/area/shuttle/salvaged_shuttle)
"rL" = (
/obj/structure/shuttle_decoration/bullbar/directional/east,
/turf/closed/wall/mineral/nanocarbon/black,
/area/shuttle/salvaged_shuttle)
"sj" = (
/obj/structure/shuttle_decoration/wall_plate/armor,
/turf/closed/wall/mineral/aluminum,
/area/shuttle/salvaged_shuttle)
"tC" = (
/obj/structure/girder/reinforced,
/turf/open/floor/plating/nanocarbon,
/area/shuttle/salvaged_shuttle)
"uk" = (
/obj/structure/railing/eva_handhold/directional/south,
/obj/structure/railing/eva_handhold/directional/north,
/obj/effect/mapping_helpers/salvage_anchor/seven,
/obj/structure/marker_beacon/jade,
/turf/open/floor/engine/anchor_jack,
/area/shuttle/salvaged_shuttle)
"uK" = (
/obj/structure/railing/eva_handhold/directional/north,
/obj/structure/shuttle_decoration/rcs/directional/north,
/turf/closed/wall/mineral/nanocarbon/yellow,
/area/shuttle/salvaged_shuttle)
"uL" = (
/obj/structure/shuttle_decoration/eva_catwalks/directional/south,
/obj/structure/shuttle_decoration/ladder/directional/south,
/turf/closed/wall/mineral/nanocarbon/yellow,
/area/shuttle/salvaged_shuttle)
"vn" = (
/obj/machinery/exoscanner/shuttle_part/radio_dish/directional/east,
/turf/closed/wall/mineral/nanocarbon/black,
/area/shuttle/salvaged_shuttle)
"vE" = (
/obj/structure/railing/eva_handhold/directional/south,
/obj/structure/railing/eva_handhold/directional/north,
/obj/effect/mapping_helpers/salvage_anchor/two,
/obj/structure/marker_beacon/jade,
/turf/open/floor/engine/anchor_jack,
/area/shuttle/salvaged_shuttle)
"wC" = (
/obj/structure/shuttle_decoration/wall_plate/plastamic,
/turf/closed/wall/mineral/aluminum,
/area/shuttle/salvaged_shuttle)
"xs" = (
/obj/structure/shuttle_decoration/rcs/directional/south,
/turf/closed/wall/mineral/nanocarbon/black,
/area/shuttle/salvaged_shuttle)
"xx" = (
/obj/structure/shuttle_decoration/wall_plate/nanocarbon/diagonal/black{
	dir = 6
	},
/turf/closed/wall/mineral/nanocarbon/black,
/area/shuttle/salvaged_shuttle)
"yi" = (
/turf/open/floor/plating/nanocarbon,
/area/shuttle/salvaged_shuttle)
"ym" = (
/obj/structure/railing/eva_handhold/directional/south,
/obj/structure/shuttle_decoration/rcs/directional/south,
/turf/closed/wall/mineral/nanocarbon/yellow,
/area/shuttle/salvaged_shuttle)
"yu" = (
/obj/structure/shuttle_decoration/wall_plate/silver_foil{
	dir = 8
	},
/turf/closed/wall/mineral/aluminum,
/area/shuttle/salvaged_shuttle)
"yx" = (
/obj/effect/mapping_helpers/salvage_anchor/end/seven,
/obj/structure/shuttle_decoration/eva_catwalks/directional/north,
/obj/structure/shuttle_decoration/wall_plate/nanocarbon/yellow{
	dir = 1
	},
/turf/closed/wall/mineral/nanocarbon/yellow,
/area/shuttle/salvaged_shuttle)
"yZ" = (
/obj/machinery/portable_atmospherics/canister/plasma,
/turf/open/floor/plating/nanocarbon,
/area/shuttle/salvaged_shuttle)
"zd" = (
/obj/structure/railing/eva_handhold/directional/north,
/turf/closed/wall/mineral/nanocarbon/black,
/area/shuttle/salvaged_shuttle)
"zm" = (
/obj/structure/mineral_door/manual_colony_door,
/turf/open/floor/iron/colony/white/texture,
/area/shuttle/salvaged_shuttle)
"Av" = (
/obj/effect/mapping_helpers/salvage_anchor/end/four,
/obj/structure/shuttle_decoration/wall_plate/nanocarbon/black,
/turf/closed/wall/mineral/nanocarbon/black,
/area/shuttle/salvaged_shuttle)
"BC" = (
/obj/structure/shuttle_decoration/wall_plate/nanocarbon/diagonal/yellow{
	dir = 5
	},
/turf/closed/wall/mineral/nanocarbon/yellow,
/area/shuttle/salvaged_shuttle)
"BV" = (
/turf/open/floor/iron/colony/texture,
/area/shuttle/salvaged_shuttle)
"BW" = (
/obj/machinery/light/blacklight/directional/south,
/turf/open/floor/iron/colony,
/area/shuttle/salvaged_shuttle)
"CC" = (
/turf/open/floor/iron/colony/bolts,
/area/shuttle/salvaged_shuttle)
"CO" = (
/obj/structure/reagent_dispensers/fueltank/large,
/turf/open/floor/plating/aluminum,
/area/shuttle/salvaged_shuttle)
"CU" = (
/turf/closed/wall/mineral/nanocarbon/nodiagonal/black,
/area/shuttle/salvaged_shuttle)
"Dm" = (
/obj/structure/railing/eva_handhold/directional/south,
/obj/structure/railing/eva_handhold/directional/north,
/obj/effect/mapping_helpers/salvage_anchor/six,
/obj/structure/marker_beacon/jade,
/turf/open/floor/engine/anchor_jack,
/area/shuttle/salvaged_shuttle)
"Dp" = (
/obj/effect/mapping_helpers/salvage_anchor/end/five,
/obj/structure/shuttle_decoration/wall_plate/nanocarbon/yellow{
	dir = 1
	},
/turf/closed/wall/mineral/nanocarbon/yellow,
/area/shuttle/salvaged_shuttle)
"Du" = (
/obj/structure/lattice,
/turf/template_noop,
/area/shuttle/salvaged_shuttle)
"Em" = (
/obj/structure/railing/eva_handhold/directional/south,
/obj/structure/railing/eva_handhold/directional/north,
/obj/effect/mapping_helpers/salvage_anchor/three,
/obj/structure/marker_beacon/jade,
/turf/open/floor/engine/anchor_jack,
/area/shuttle/salvaged_shuttle)
"Ev" = (
/obj/structure/railing/eva_handhold/directional/south,
/obj/structure/railing/eva_handhold/directional/north,
/obj/effect/mapping_helpers/salvage_anchor/four,
/obj/structure/marker_beacon/jade,
/turf/open/floor/engine/anchor_jack,
/area/shuttle/salvaged_shuttle)
"Ew" = (
/obj/structure/marker_beacon/jade,
/obj/structure/railing/eva_handhold/directional/north,
/turf/closed/wall/mineral/nanocarbon/nodiagonal/black,
/area/shuttle/salvaged_shuttle)
"Ex" = (
/obj/machinery/exoscanner/shuttle_part/open_sensors_blister/directional/south,
/turf/closed/wall/mineral/nanocarbon/yellow,
/area/shuttle/salvaged_shuttle)
"Fg" = (
/obj/structure/shuttle_decoration/eva_catwalks/directional/north,
/obj/structure/shuttle_decoration/wall_plate/nanocarbon/yellow{
	dir = 1
	},
/turf/closed/wall/mineral/nanocarbon/yellow,
/area/shuttle/salvaged_shuttle)
"Fz" = (
/obj/structure/shuttle_decoration/wall_plate/gold_foil,
/obj/structure/shuttle_decoration/wall_plate/plastamic{
	dir = 1
	},
/turf/closed/wall/mineral/aluminum,
/area/shuttle/salvaged_shuttle)
"Gu" = (
/obj/structure/shuttle_decoration/aux_engine/directional/west,
/turf/closed/wall/mineral/nanocarbon/black,
/area/shuttle/salvaged_shuttle)
"Gy" = (
/obj/structure/shuttle_decoration/wall_plate/nanocarbon/black{
	dir = 1
	},
/turf/closed/wall/mineral/nanocarbon/black,
/area/shuttle/salvaged_shuttle)
"HR" = (
/obj/structure/railing/eva_handhold/directional/south,
/obj/structure/railing/eva_handhold/directional/north,
/obj/structure/marker_beacon/yellow,
/turf/open/floor/engine/anchor_jack,
/area/shuttle/salvaged_shuttle)
"Ii" = (
/obj/structure/railing/eva_handhold/directional/south,
/obj/structure/railing/eva_handhold/directional/north,
/obj/effect/mapping_helpers/salvage_anchor/one,
/obj/structure/marker_beacon/jade,
/turf/open/floor/engine/anchor_jack,
/area/shuttle/salvaged_shuttle)
"Im" = (
/obj/machinery/light/cold/directional/south,
/turf/open/floor/iron/colony/bolts,
/area/shuttle/salvaged_shuttle)
"IG" = (
/obj/machinery/light/cold/directional/north,
/turf/open/floor/iron/colony/bolts,
/area/shuttle/salvaged_shuttle)
"IM" = (
/obj/structure/grille,
/turf/open/floor/plating/nanocarbon,
/area/shuttle/salvaged_shuttle)
"IP" = (
/obj/machinery/computer/old{
	dir = 8
	},
/turf/open/floor/iron/colony,
/area/shuttle/salvaged_shuttle)
"IZ" = (
/obj/structure/reagent_dispensers/fueltank/large,
/obj/machinery/light/cold/directional/north,
/turf/open/floor/iron/colony/bolts,
/area/shuttle/salvaged_shuttle)
"Jd" = (
/obj/structure/marker_beacon/jade,
/turf/closed/wall/mineral/nanocarbon/black,
/area/shuttle/salvaged_shuttle)
"Kv" = (
/obj/machinery/power/shuttle_engine/propulsion{
	dir = 8
	},
/turf/open/floor/plating/nanocarbon,
/area/shuttle/salvaged_shuttle)
"KV" = (
/obj/effect/mapping_helpers/salvage_anchor/end/one,
/obj/structure/shuttle_decoration/landing_engine/directional/south,
/turf/closed/wall/mineral/nanocarbon/black,
/area/shuttle/salvaged_shuttle)
"LH" = (
/obj/effect/mapping_helpers/salvage_anchor/end/eight,
/obj/structure/shuttle_decoration/landing_engine/directional/north,
/turf/closed/wall/mineral/nanocarbon/black,
/area/shuttle/salvaged_shuttle)
"LJ" = (
/obj/effect/mapping_helpers/salvage_anchor/end/three,
/obj/structure/shuttle_decoration/eva_catwalks/directional/south,
/obj/structure/shuttle_decoration/wall_plate/nanocarbon/black,
/turf/closed/wall/mineral/nanocarbon/black,
/area/shuttle/salvaged_shuttle)
"LK" = (
/obj/machinery/power/micro_reactor,
/turf/open/floor/plating,
/area/shuttle/salvaged_shuttle)
"LV" = (
/obj/effect/mapping_helpers/salvage_anchor/end/six,
/obj/structure/shuttle_decoration/wall_plate/nanocarbon/black{
	dir = 1
	},
/turf/closed/wall/mineral/nanocarbon/black,
/area/shuttle/salvaged_shuttle)
"Md" = (
/obj/effect/mapping_helpers/salvage_anchor/end/two,
/obj/structure/shuttle_decoration/eva_catwalks/directional/south,
/obj/structure/shuttle_decoration/wall_plate/nanocarbon/yellow,
/turf/closed/wall/mineral/nanocarbon/yellow,
/area/shuttle/salvaged_shuttle)
"MV" = (
/obj/docking_port/mobile/salvage,
/obj/structure/railing/eva_handhold/directional/south,
/obj/structure/railing/eva_handhold/directional/north,
/obj/structure/marker_beacon/yellow,
/turf/open/floor/engine/anchor_jack,
/area/shuttle/salvaged_shuttle)
"No" = (
/obj/structure/shuttle_decoration/eva_catwalks/directional/south,
/obj/structure/shuttle_decoration/extinguisher/directional/south,
/turf/closed/wall/mineral/nanocarbon/black,
/area/shuttle/salvaged_shuttle)
"Oe" = (
/obj/structure/shuttle_decoration/headlight/directional/east,
/turf/closed/wall/mineral/nanocarbon/black,
/area/shuttle/salvaged_shuttle)
"Ow" = (
/obj/machinery/light/blacklight/directional/north,
/turf/open/floor/iron/colony,
/area/shuttle/salvaged_shuttle)
"Pp" = (
/obj/structure/chair/comfy/shuttle{
	dir = 4
	},
/obj/machinery/light/cold/directional/south,
/turf/open/floor/iron/colony/bolts,
/area/shuttle/salvaged_shuttle)
"QT" = (
/obj/structure/railing/eva_handhold/directional/north,
/turf/closed/wall/mineral/nanocarbon/yellow,
/area/shuttle/salvaged_shuttle)
"RM" = (
/obj/structure/chair/comfy/shuttle{
	dir = 4
	},
/obj/machinery/light/cold/directional/north,
/turf/open/floor/iron/colony/bolts,
/area/shuttle/salvaged_shuttle)
"RS" = (
/turf/closed/wall/mineral/nanocarbon/black,
/area/shuttle/salvaged_shuttle)
"Sv" = (
/obj/structure/railing/eva_handhold/directional/south,
/obj/structure/railing/eva_handhold/directional/north,
/obj/effect/mapping_helpers/salvage_anchor/eight,
/obj/structure/marker_beacon/jade,
/turf/open/floor/engine/anchor_jack,
/area/shuttle/salvaged_shuttle)
"Tf" = (
/obj/structure/shuttle_decoration/wall_plate/gold_foil{
	dir = 1
	},
/obj/structure/shuttle_decoration/wall_plate/plastamic,
/turf/closed/wall/mineral/aluminum,
/area/shuttle/salvaged_shuttle)
"UE" = (
/obj/structure/shuttle_decoration/wall_plate/armor{
	dir = 1
	},
/turf/closed/wall/mineral/aluminum,
/area/shuttle/salvaged_shuttle)
"UN" = (
/obj/structure/shuttle_decoration/eva_catwalks/directional/north,
/obj/structure/shuttle_decoration/wall_plate/nanocarbon/black{
	dir = 1
	},
/turf/closed/wall/mineral/nanocarbon/black,
/area/shuttle/salvaged_shuttle)
"UU" = (
/turf/closed/wall/mineral/aluminum,
/area/shuttle/salvaged_shuttle)
"VR" = (
/obj/structure/shuttle_decoration/eva_catwalks/directional/south,
/obj/structure/shuttle_decoration/wall_plate/nanocarbon/black,
/turf/closed/wall/mineral/nanocarbon/black,
/area/shuttle/salvaged_shuttle)
"Xt" = (
/obj/structure/shuttle_decoration/wall_plate/nanocarbon/black,
/turf/closed/wall/mineral/nanocarbon/black,
/area/shuttle/salvaged_shuttle)
"Yj" = (
/obj/machinery/portable_atmospherics/canister/freon,
/turf/open/floor/plating/nanocarbon,
/area/shuttle/salvaged_shuttle)
"YC" = (
/turf/template_noop,
/area/template_noop)
"YR" = (
/obj/structure/marker_beacon/burgundy,
/turf/closed/wall/mineral/nanocarbon/black,
/area/shuttle/salvaged_shuttle)

(1,1,1) = {"
YC
YC
YC
YC
YC
YC
YC
YC
YC
YC
YC
YC
YC
YC
YC
YC
YC
YC
YC
"}
(2,1,1) = {"
YC
YC
YC
YC
YC
YC
YC
YC
YC
YC
YC
YC
YC
YC
YC
YC
YC
YC
YC
"}
(3,1,1) = {"
YC
YC
YC
YC
YC
YC
YC
YC
YC
YC
YC
YC
YC
YC
YC
YC
YC
YC
YC
"}
(4,1,1) = {"
YC
Sv
YC
YC
YC
YC
YC
YC
YC
YC
YC
YC
YC
YC
YC
YC
YC
Ii
YC
"}
(5,1,1) = {"
YC
YC
YC
YC
YC
YC
YC
YC
YC
YC
YC
YC
YC
YC
YC
YC
YC
YC
YC
"}
(6,1,1) = {"
YC
YC
YC
YC
YC
YC
YC
YC
YC
YC
YC
YC
YC
YC
YC
YC
YC
YC
YC
"}
(7,1,1) = {"
YC
YC
YC
YC
YC
YC
YC
Jd
md
Kv
md
YR
YC
YC
YC
YC
YC
YC
YC
"}
(8,1,1) = {"
YC
HR
YC
YC
YC
UE
YC
LH
mH
nw
mH
KV
YC
sj
YC
YC
YC
HR
YC
"}
(9,1,1) = {"
YC
YC
YC
YC
YC
UE
YC
RS
Ow
LK
BW
RS
YC
sj
YC
YC
YC
YC
YC
"}
(10,1,1) = {"
YC
YC
YC
YC
YC
Ew
Gu
CU
yu
nP
yu
CU
Gu
kZ
YC
YC
YC
YC
YC
"}
(11,1,1) = {"
YC
YC
YC
YC
YC
jv
yZ
Tf
IG
kO
Im
Fz
yZ
xs
YC
YC
YC
YC
YC
"}
(12,1,1) = {"
uk
YC
YC
YC
YC
Fg
yi
tC
CO
rb
rb
tC
yi
uL
YC
YC
bo
YC
vE
"}
(13,1,1) = {"
YC
YC
YC
YC
YC
yx
yi
tC
rb
rb
rb
tC
yi
Md
YC
YC
km
YC
YC
"}
(14,1,1) = {"
YC
YC
YC
YC
YC
UN
ce
tC
rb
rb
rb
tC
yi
No
YC
YC
YC
YC
YC
"}
(15,1,1) = {"
YC
YC
YC
YC
YC
Gy
yi
Tf
IZ
kO
Im
Fz
yi
Xt
YC
YC
YC
YC
YC
"}
(16,1,1) = {"
HR
YC
YC
YC
YC
QT
ik
UU
UU
BV
UU
gM
IM
Ex
YC
YC
YC
YC
MV
"}
(17,1,1) = {"
YC
YC
YC
YC
YC
zm
pH
zm
CC
kO
CC
Fz
yi
iy
YC
YC
YC
YC
YC
"}
(18,1,1) = {"
YC
YC
YC
YC
YC
zd
ly
wC
IG
kO
Im
Fz
yi
VR
YC
YC
YC
YC
YC
"}
(19,1,1) = {"
YC
YC
YC
YC
YC
LV
yi
nN
UU
nP
UU
gM
IM
LJ
YC
YC
YC
YC
YC
"}
(20,1,1) = {"
Dm
YC
YC
YC
YC
uK
Yj
Tf
CC
kO
CC
Fz
yi
ym
YC
YC
YC
YC
Em
"}
(21,1,1) = {"
YC
YC
YC
YC
YC
oM
ez
CU
RM
kO
Pp
CU
ez
fI
YC
YC
YC
YC
YC
"}
(22,1,1) = {"
YC
YC
YC
YC
YC
YC
Du
kP
IP
CC
IP
cP
Du
YC
YC
YC
YC
YC
YC
"}
(23,1,1) = {"
YC
YC
YC
YC
YC
pa
Du
Jd
Oe
tC
vn
YR
Du
Xt
YC
YC
YC
YC
YC
"}
(24,1,1) = {"
YC
HR
YC
YC
YC
Dp
Du
YC
YC
YC
YC
YC
Du
Av
YC
YC
YC
HR
YC
"}
(25,1,1) = {"
YC
YC
YC
YC
YC
BC
iA
YC
YC
YC
YC
YC
rL
xx
YC
YC
YC
YC
YC
"}
(26,1,1) = {"
YC
YC
YC
YC
YC
YC
YC
YC
YC
YC
YC
YC
YC
YC
YC
YC
YC
YC
YC
"}
(27,1,1) = {"
YC
YC
YC
YC
YC
YC
YC
YC
YC
YC
YC
YC
YC
YC
YC
YC
YC
YC
YC
"}
(28,1,1) = {"
YC
dD
YC
YC
YC
YC
YC
YC
YC
YC
YC
YC
YC
YC
YC
YC
YC
Ev
YC
"}
(29,1,1) = {"
YC
YC
YC
YC
YC
YC
YC
YC
YC
YC
YC
YC
YC
YC
YC
YC
YC
YC
YC
"}
(30,1,1) = {"
YC
YC
YC
YC
YC
YC
YC
YC
YC
YC
YC
YC
YC
YC
YC
YC
YC
YC
YC
"}
(31,1,1) = {"
YC
YC
YC
YC
YC
YC
YC
YC
YC
YC
YC
YC
YC
YC
YC
YC
YC
YC
YC
"}
