//MAP CONVERTED BY dmm2tgm.py THIS HEADER COMMENT PREVENTS RECONVERSION, DO NOT REMOVE
"ce" = (
/obj/machinery/portable_atmospherics/canister/freon,
/turf/open/floor/plating,
/area/shuttle/salvaged_shuttle)
"dD" = (
/obj/structure/railing/eva_handhold/directional/south,
/obj/structure/railing/eva_handhold/directional/north,
/obj/effect/mapping_helpers/salvage_anchor/five,
/obj/structure/marker_beacon/jade,
/turf/open/floor/engine/anchor_jack,
/area/shuttle/salvaged_shuttle)
"ez" = (
/obj/machinery/power/shuttle_engine/heater{
	dir = 8
	},
/turf/open/floor/plating,
/area/shuttle/salvaged_shuttle)
"fI" = (
/obj/structure/chair/comfy/shuttle{
	dir = 4
	},
/obj/machinery/light/cold/directional/south,
/turf/open/floor/iron/colony/bolts,
/area/shuttle/salvaged_shuttle)
"kO" = (
/turf/open/floor/catwalk_floor/colony_fabricator,
/area/shuttle/salvaged_shuttle)
"kZ" = (
/obj/structure/lattice,
/turf/template_noop,
/area/shuttle/salvaged_shuttle)
"mH" = (
/turf/open/floor/iron/colony,
/area/shuttle/salvaged_shuttle)
"nw" = (
/obj/structure/railing/eva_handhold/directional/south,
/obj/effect/mapping_helpers/salvage_anchor/end/one,
/turf/closed/wall/mineral/nanocarbon/black,
/area/shuttle/salvaged_shuttle)
"nP" = (
/obj/structure/mineral_door/manual_colony_door,
/turf/open/floor/iron/colony/texture,
/area/shuttle/salvaged_shuttle)
"oO" = (
/obj/machinery/light/cold/directional/north,
/turf/open/floor/iron/colony/bolts,
/area/shuttle/salvaged_shuttle)
"pH" = (
/obj/machinery/computer/old{
	dir = 8
	},
/turf/open/floor/iron/colony,
/area/shuttle/salvaged_shuttle)
"tE" = (
/obj/structure/marker_beacon/burgundy,
/turf/closed/wall/mineral/nanocarbon/nodiagonal/black,
/area/shuttle/salvaged_shuttle)
"uk" = (
/obj/structure/railing/eva_handhold/directional/south,
/obj/structure/railing/eva_handhold/directional/north,
/obj/effect/mapping_helpers/salvage_anchor/seven,
/obj/structure/marker_beacon/jade,
/turf/open/floor/engine/anchor_jack,
/area/shuttle/salvaged_shuttle)
"vE" = (
/obj/structure/railing/eva_handhold/directional/south,
/obj/structure/railing/eva_handhold/directional/north,
/obj/effect/mapping_helpers/salvage_anchor/two,
/obj/structure/marker_beacon/jade,
/turf/open/floor/engine/anchor_jack,
/area/shuttle/salvaged_shuttle)
"xp" = (
/turf/open/floor/iron/colony/bolts,
/area/shuttle/salvaged_shuttle)
"yi" = (
/turf/open/floor/plating,
/area/shuttle/salvaged_shuttle)
"ym" = (
/obj/structure/railing/eva_handhold/directional/south,
/turf/closed/wall/mineral/nanocarbon/yellow,
/area/shuttle/salvaged_shuttle)
"yx" = (
/obj/structure/railing/eva_handhold/directional/north,
/obj/effect/mapping_helpers/salvage_anchor/end/seven,
/turf/closed/wall/mineral/nanocarbon/yellow,
/area/shuttle/salvaged_shuttle)
"yR" = (
/obj/structure/marker_beacon/jade,
/turf/closed/wall/mineral/nanocarbon/yellow,
/area/shuttle/salvaged_shuttle)
"yZ" = (
/obj/machinery/portable_atmospherics/canister/plasma,
/turf/open/floor/plating,
/area/shuttle/salvaged_shuttle)
"zm" = (
/obj/structure/mineral_door/manual_colony_door,
/turf/open/floor/iron/colony/white/texture,
/area/shuttle/salvaged_shuttle)
"Av" = (
/obj/machinery/portable_atmospherics/canister/air,
/turf/open/floor/plating,
/area/shuttle/salvaged_shuttle)
"BV" = (
/turf/open/floor/iron/colony/texture,
/area/shuttle/salvaged_shuttle)
"CO" = (
/obj/structure/reagent_dispensers/fueltank/large,
/turf/open/floor/iron/colony/bolts,
/area/shuttle/salvaged_shuttle)
"CU" = (
/obj/structure/marker_beacon/jade,
/turf/closed/wall/mineral/nanocarbon/nodiagonal/black,
/area/shuttle/salvaged_shuttle)
"Dm" = (
/obj/structure/railing/eva_handhold/directional/south,
/obj/structure/railing/eva_handhold/directional/north,
/obj/effect/mapping_helpers/salvage_anchor/six,
/obj/structure/marker_beacon/jade,
/turf/open/floor/engine/anchor_jack,
/area/shuttle/salvaged_shuttle)
"Dp" = (
/obj/effect/mapping_helpers/salvage_anchor/end/four,
/turf/closed/wall/mineral/nanocarbon/black,
/area/shuttle/salvaged_shuttle)
"Du" = (
/obj/structure/railing/eva_handhold/directional/north,
/turf/closed/wall/mineral/nanocarbon/black,
/area/shuttle/salvaged_shuttle)
"Ef" = (
/obj/structure/chair/comfy/shuttle{
	dir = 4
	},
/obj/machinery/light/cold/directional/north,
/turf/open/floor/iron/colony/bolts,
/area/shuttle/salvaged_shuttle)
"Em" = (
/obj/structure/railing/eva_handhold/directional/south,
/obj/structure/railing/eva_handhold/directional/north,
/obj/effect/mapping_helpers/salvage_anchor/three,
/obj/structure/marker_beacon/jade,
/turf/open/floor/engine/anchor_jack,
/area/shuttle/salvaged_shuttle)
"Ev" = (
/obj/structure/railing/eva_handhold/directional/south,
/obj/structure/railing/eva_handhold/directional/north,
/obj/effect/mapping_helpers/salvage_anchor/four,
/obj/structure/marker_beacon/jade,
/turf/open/floor/engine/anchor_jack,
/area/shuttle/salvaged_shuttle)
"ER" = (
/obj/machinery/light/blacklight/directional/north,
/turf/open/floor/iron/colony,
/area/shuttle/salvaged_shuttle)
"Fo" = (
/obj/structure/railing/eva_handhold/directional/north,
/obj/effect/mapping_helpers/salvage_anchor/end/eight,
/turf/closed/wall/mineral/nanocarbon/black,
/area/shuttle/salvaged_shuttle)
"HR" = (
/obj/structure/railing/eva_handhold/directional/south,
/obj/structure/railing/eva_handhold/directional/north,
/obj/structure/marker_beacon/yellow,
/turf/open/floor/engine/anchor_jack,
/area/shuttle/salvaged_shuttle)
"Ii" = (
/obj/structure/railing/eva_handhold/directional/south,
/obj/structure/railing/eva_handhold/directional/north,
/obj/effect/mapping_helpers/salvage_anchor/one,
/obj/structure/marker_beacon/jade,
/turf/open/floor/engine/anchor_jack,
/area/shuttle/salvaged_shuttle)
"Im" = (
/obj/machinery/light/cold/directional/south,
/turf/open/floor/iron/colony/bolts,
/area/shuttle/salvaged_shuttle)
"IH" = (
/obj/machinery/power/micro_reactor,
/turf/open/floor/plating,
/area/shuttle/salvaged_shuttle)
"IZ" = (
/obj/structure/reagent_dispensers/fueltank/large,
/obj/machinery/light/cold/directional/north,
/turf/open/floor/iron/colony/bolts,
/area/shuttle/salvaged_shuttle)
"Jd" = (
/obj/structure/grille,
/turf/open/floor/plating,
/area/shuttle/salvaged_shuttle)
"KV" = (
/obj/structure/railing/eva_handhold/directional/south,
/turf/closed/wall/mineral/nanocarbon/black,
/area/shuttle/salvaged_shuttle)
"LH" = (
/obj/effect/mapping_helpers/salvage_anchor/end/five,
/turf/closed/wall/mineral/nanocarbon/yellow,
/area/shuttle/salvaged_shuttle)
"LJ" = (
/obj/effect/mapping_helpers/salvage_anchor/end/three,
/turf/closed/wall/mineral/nanocarbon/black,
/area/shuttle/salvaged_shuttle)
"LK" = (
/obj/structure/marker_beacon/jade,
/turf/closed/wall/mineral/nanocarbon/black,
/area/shuttle/salvaged_shuttle)
"LV" = (
/obj/effect/mapping_helpers/salvage_anchor/end/six,
/turf/closed/wall/mineral/nanocarbon/black,
/area/shuttle/salvaged_shuttle)
"Md" = (
/obj/structure/railing/eva_handhold/directional/south,
/obj/effect/mapping_helpers/salvage_anchor/end/two,
/turf/closed/wall/mineral/nanocarbon/yellow,
/area/shuttle/salvaged_shuttle)
"MV" = (
/obj/docking_port/mobile/salvage,
/obj/structure/railing/eva_handhold/directional/south,
/obj/structure/railing/eva_handhold/directional/north,
/obj/structure/marker_beacon/yellow,
/turf/open/floor/engine/anchor_jack,
/area/shuttle/salvaged_shuttle)
"Ow" = (
/obj/structure/marker_beacon/burgundy,
/turf/closed/wall/mineral/nanocarbon/black,
/area/shuttle/salvaged_shuttle)
"Pp" = (
/obj/machinery/light/cold/dim/directional/west,
/turf/open/floor/catwalk_floor/colony_fabricator,
/area/shuttle/salvaged_shuttle)
"PY" = (
/obj/structure/girder/reinforced,
/turf/open/floor/plating,
/area/shuttle/salvaged_shuttle)
"QT" = (
/obj/structure/railing/eva_handhold/directional/north,
/turf/closed/wall/mineral/nanocarbon/yellow,
/area/shuttle/salvaged_shuttle)
"RM" = (
/turf/closed/wall/mineral/nanocarbon/black,
/area/shuttle/salvaged_shuttle)
"Sv" = (
/obj/structure/railing/eva_handhold/directional/south,
/obj/structure/railing/eva_handhold/directional/north,
/obj/effect/mapping_helpers/salvage_anchor/eight,
/obj/structure/marker_beacon/jade,
/turf/open/floor/engine/anchor_jack,
/area/shuttle/salvaged_shuttle)
"Ti" = (
/obj/machinery/power/shuttle_engine/propulsion{
	dir = 8
	},
/turf/open/floor/plating,
/area/shuttle/salvaged_shuttle)
"TJ" = (
/obj/machinery/light/blacklight/directional/south,
/turf/open/floor/iron/colony,
/area/shuttle/salvaged_shuttle)
"Wb" = (
/turf/closed/wall/mineral/aluminum,
/area/shuttle/salvaged_shuttle)
"Xs" = (
/turf/closed/wall/mineral/nanocarbon/yellow,
/area/shuttle/salvaged_shuttle)
"YC" = (
/turf/template_noop,
/area/template_noop)
"YR" = (
/obj/structure/marker_beacon/burgundy,
/turf/closed/wall/mineral/nanocarbon/yellow,
/area/shuttle/salvaged_shuttle)

(1,1,1) = {"
YC
YC
YC
YC
YC
YC
YC
YC
YC
YC
YC
YC
YC
YC
YC
YC
YC
YC
YC
"}
(2,1,1) = {"
YC
YC
YC
YC
YC
YC
YC
YC
YC
YC
YC
YC
YC
YC
YC
YC
YC
YC
YC
"}
(3,1,1) = {"
YC
YC
YC
YC
YC
YC
YC
YC
YC
YC
YC
YC
YC
YC
YC
YC
YC
YC
YC
"}
(4,1,1) = {"
YC
Sv
YC
YC
YC
YC
YC
YC
YC
YC
YC
YC
YC
YC
YC
YC
YC
Ii
YC
"}
(5,1,1) = {"
YC
YC
YC
YC
YC
YC
YC
YC
YC
YC
YC
YC
YC
YC
YC
YC
YC
YC
YC
"}
(6,1,1) = {"
YC
YC
YC
YC
YC
YC
YC
YC
YC
YC
YC
YC
YC
YC
YC
YC
YC
YC
YC
"}
(7,1,1) = {"
YC
YC
YC
YC
YC
YC
YC
LK
RM
Ti
RM
Ow
YC
YC
YC
YC
YC
YC
YC
"}
(8,1,1) = {"
YC
HR
YC
YC
YC
Wb
YC
Fo
mH
ez
mH
nw
YC
Wb
YC
YC
YC
HR
YC
"}
(9,1,1) = {"
YC
YC
YC
YC
YC
Wb
YC
RM
ER
IH
TJ
RM
YC
Wb
YC
YC
YC
YC
YC
"}
(10,1,1) = {"
YC
YC
YC
YC
YC
CU
RM
RM
Wb
nP
Wb
RM
RM
tE
YC
YC
YC
YC
YC
"}
(11,1,1) = {"
YC
YC
YC
YC
YC
Du
yZ
Wb
oO
kO
Im
Wb
yZ
KV
YC
YC
YC
YC
YC
"}
(12,1,1) = {"
uk
YC
YC
YC
YC
Xs
yi
PY
CO
kO
xp
PY
yi
Xs
YC
YC
YC
YC
vE
"}
(13,1,1) = {"
YC
YC
YC
YC
YC
yx
yi
PY
mH
xp
mH
PY
yi
Md
YC
YC
YC
YC
YC
"}
(14,1,1) = {"
YC
YC
YC
YC
YC
Du
Av
PY
xp
kO
xp
PY
yi
KV
YC
YC
YC
YC
YC
"}
(15,1,1) = {"
YC
YC
YC
YC
YC
RM
yi
Wb
IZ
kO
Im
Wb
yi
RM
YC
YC
YC
YC
YC
"}
(16,1,1) = {"
HR
YC
YC
YC
YC
QT
Wb
Wb
Wb
BV
Wb
Wb
Jd
ym
YC
YC
YC
YC
MV
"}
(17,1,1) = {"
YC
YC
YC
YC
YC
zm
Pp
zm
xp
kO
xp
Wb
yi
Xs
YC
YC
YC
YC
YC
"}
(18,1,1) = {"
YC
YC
YC
YC
YC
Du
Wb
Wb
oO
kO
Im
Wb
yi
KV
YC
YC
YC
YC
YC
"}
(19,1,1) = {"
YC
YC
YC
YC
YC
LV
yi
Wb
Wb
nP
Wb
Wb
Jd
LJ
YC
YC
YC
YC
YC
"}
(20,1,1) = {"
Dm
YC
YC
YC
YC
QT
ce
Wb
xp
kO
xp
Wb
yi
ym
YC
YC
YC
YC
Em
"}
(21,1,1) = {"
YC
YC
YC
YC
YC
yR
Xs
RM
Ef
kO
fI
RM
Xs
YR
YC
YC
YC
YC
YC
"}
(22,1,1) = {"
YC
YC
YC
YC
YC
YC
kZ
RM
pH
xp
pH
RM
kZ
YC
YC
YC
YC
YC
YC
"}
(23,1,1) = {"
YC
YC
YC
YC
YC
Xs
kZ
LK
RM
PY
RM
Ow
kZ
RM
YC
YC
YC
YC
YC
"}
(24,1,1) = {"
YC
HR
YC
YC
YC
LH
kZ
YC
YC
YC
YC
YC
kZ
Dp
YC
YC
YC
HR
YC
"}
(25,1,1) = {"
YC
YC
YC
YC
YC
Xs
Xs
YC
YC
YC
YC
YC
RM
RM
YC
YC
YC
YC
YC
"}
(26,1,1) = {"
YC
YC
YC
YC
YC
YC
YC
YC
YC
YC
YC
YC
YC
YC
YC
YC
YC
YC
YC
"}
(27,1,1) = {"
YC
YC
YC
YC
YC
YC
YC
YC
YC
YC
YC
YC
YC
YC
YC
YC
YC
YC
YC
"}
(28,1,1) = {"
YC
dD
YC
YC
YC
YC
YC
YC
YC
YC
YC
YC
YC
YC
YC
YC
YC
Ev
YC
"}
(29,1,1) = {"
YC
YC
YC
YC
YC
YC
YC
YC
YC
YC
YC
YC
YC
YC
YC
YC
YC
YC
YC
"}
(30,1,1) = {"
YC
YC
YC
YC
YC
YC
YC
YC
YC
YC
YC
YC
YC
YC
YC
YC
YC
YC
YC
"}
(31,1,1) = {"
YC
YC
YC
YC
YC
YC
YC
YC
YC
YC
YC
YC
YC
YC
YC
YC
YC
YC
YC
"}
