//MAP CONVERTED BY dmm2tgm.py THIS HEADER COMMENT PREVENTS RECONVERSION, DO NOT REMOVE
"ce" = (
/obj/machinery/portable_atmospherics/canister/air,
/turf/open/floor/plating,
/area/shuttle/salvaged_shuttle)
"dD" = (
/obj/structure/railing/eva_handhold/directional/south,
/obj/structure/railing/eva_handhold/directional/north,
/obj/effect/mapping_helpers/salvage_anchor/five,
/obj/structure/marker_beacon/jade,
/turf/open/floor/engine/anchor_jack,
/area/shuttle/salvaged_shuttle)
"ez" = (
/turf/closed/wall/mineral/nanocarbon/yellow,
/area/shuttle/salvaged_shuttle)
"fI" = (
/obj/structure/marker_beacon/burgundy,
/turf/closed/wall/mineral/nanocarbon/yellow,
/area/shuttle/salvaged_shuttle)
"jv" = (
/obj/structure/railing/eva_handhold/directional/south,
/turf/closed/wall/mineral/nanocarbon/black,
/area/shuttle/salvaged_shuttle)
"kO" = (
/turf/open/floor/catwalk_floor/colony_fabricator,
/area/shuttle/salvaged_shuttle)
"kZ" = (
/obj/structure/marker_beacon/burgundy,
/turf/closed/wall/mineral/nanocarbon/nodiagonal/black,
/area/shuttle/salvaged_shuttle)
"mH" = (
/turf/open/floor/iron/colony,
/area/shuttle/salvaged_shuttle)
"nw" = (
/obj/machinery/power/shuttle_engine/heater{
	dir = 8
	},
/turf/open/floor/plating,
/area/shuttle/salvaged_shuttle)
"nP" = (
/obj/structure/mineral_door/manual_colony_door,
/turf/open/floor/iron/colony/texture,
/area/shuttle/salvaged_shuttle)
"oM" = (
/obj/structure/marker_beacon/jade,
/turf/closed/wall/mineral/nanocarbon/yellow,
/area/shuttle/salvaged_shuttle)
"pH" = (
/obj/machinery/light/cold/dim/directional/west,
/turf/open/floor/catwalk_floor/colony_fabricator,
/area/shuttle/salvaged_shuttle)
"tC" = (
/obj/structure/girder/reinforced,
/turf/open/floor/plating,
/area/shuttle/salvaged_shuttle)
"uk" = (
/obj/structure/railing/eva_handhold/directional/south,
/obj/structure/railing/eva_handhold/directional/north,
/obj/effect/mapping_helpers/salvage_anchor/seven,
/obj/structure/marker_beacon/jade,
/turf/open/floor/engine/anchor_jack,
/area/shuttle/salvaged_shuttle)
"vE" = (
/obj/structure/railing/eva_handhold/directional/south,
/obj/structure/railing/eva_handhold/directional/north,
/obj/effect/mapping_helpers/salvage_anchor/two,
/obj/structure/marker_beacon/jade,
/turf/open/floor/engine/anchor_jack,
/area/shuttle/salvaged_shuttle)
"yi" = (
/turf/open/floor/plating,
/area/shuttle/salvaged_shuttle)
"ym" = (
/obj/structure/railing/eva_handhold/directional/south,
/turf/closed/wall/mineral/nanocarbon/yellow,
/area/shuttle/salvaged_shuttle)
"yx" = (
/obj/structure/railing/eva_handhold/directional/north,
/obj/effect/mapping_helpers/salvage_anchor/end/seven,
/turf/closed/wall/mineral/nanocarbon/yellow,
/area/shuttle/salvaged_shuttle)
"yZ" = (
/obj/machinery/portable_atmospherics/canister/plasma,
/turf/open/floor/plating,
/area/shuttle/salvaged_shuttle)
"zd" = (
/obj/structure/railing/eva_handhold/directional/north,
/turf/closed/wall/mineral/nanocarbon/black,
/area/shuttle/salvaged_shuttle)
"zm" = (
/obj/structure/mineral_door/manual_colony_door,
/turf/open/floor/iron/colony/white/texture,
/area/shuttle/salvaged_shuttle)
"Av" = (
/obj/effect/mapping_helpers/salvage_anchor/end/four,
/turf/closed/wall/mineral/nanocarbon/black,
/area/shuttle/salvaged_shuttle)
"BV" = (
/turf/open/floor/iron/colony/texture,
/area/shuttle/salvaged_shuttle)
"BW" = (
/obj/machinery/light/blacklight/directional/south,
/turf/open/floor/iron/colony,
/area/shuttle/salvaged_shuttle)
"CC" = (
/turf/open/floor/iron/colony/bolts,
/area/shuttle/salvaged_shuttle)
"CO" = (
/obj/structure/reagent_dispensers/fueltank/large,
/turf/open/floor/iron/colony/bolts,
/area/shuttle/salvaged_shuttle)
"CU" = (
/turf/closed/wall/mineral/nanocarbon/nodiagonal/black,
/area/shuttle/salvaged_shuttle)
"Dm" = (
/obj/structure/railing/eva_handhold/directional/south,
/obj/structure/railing/eva_handhold/directional/north,
/obj/effect/mapping_helpers/salvage_anchor/six,
/obj/structure/marker_beacon/jade,
/turf/open/floor/engine/anchor_jack,
/area/shuttle/salvaged_shuttle)
"Dp" = (
/obj/effect/mapping_helpers/salvage_anchor/end/five,
/turf/closed/wall/mineral/nanocarbon/yellow,
/area/shuttle/salvaged_shuttle)
"Du" = (
/obj/structure/lattice,
/turf/template_noop,
/area/shuttle/salvaged_shuttle)
"Em" = (
/obj/structure/railing/eva_handhold/directional/south,
/obj/structure/railing/eva_handhold/directional/north,
/obj/effect/mapping_helpers/salvage_anchor/three,
/obj/structure/marker_beacon/jade,
/turf/open/floor/engine/anchor_jack,
/area/shuttle/salvaged_shuttle)
"Ev" = (
/obj/structure/railing/eva_handhold/directional/south,
/obj/structure/railing/eva_handhold/directional/north,
/obj/effect/mapping_helpers/salvage_anchor/four,
/obj/structure/marker_beacon/jade,
/turf/open/floor/engine/anchor_jack,
/area/shuttle/salvaged_shuttle)
"Ew" = (
/obj/structure/marker_beacon/jade,
/turf/closed/wall/mineral/nanocarbon/nodiagonal/black,
/area/shuttle/salvaged_shuttle)
"HR" = (
/obj/structure/railing/eva_handhold/directional/south,
/obj/structure/railing/eva_handhold/directional/north,
/obj/structure/marker_beacon/yellow,
/turf/open/floor/engine/anchor_jack,
/area/shuttle/salvaged_shuttle)
"Ii" = (
/obj/structure/railing/eva_handhold/directional/south,
/obj/structure/railing/eva_handhold/directional/north,
/obj/effect/mapping_helpers/salvage_anchor/one,
/obj/structure/marker_beacon/jade,
/turf/open/floor/engine/anchor_jack,
/area/shuttle/salvaged_shuttle)
"Im" = (
/obj/machinery/light/cold/directional/south,
/turf/open/floor/iron/colony/bolts,
/area/shuttle/salvaged_shuttle)
"IG" = (
/obj/machinery/light/cold/directional/north,
/turf/open/floor/iron/colony/bolts,
/area/shuttle/salvaged_shuttle)
"IM" = (
/obj/structure/grille,
/turf/open/floor/plating,
/area/shuttle/salvaged_shuttle)
"IP" = (
/obj/machinery/computer/old{
	dir = 8
	},
/turf/open/floor/iron/colony,
/area/shuttle/salvaged_shuttle)
"IZ" = (
/obj/structure/reagent_dispensers/fueltank/large,
/obj/machinery/light/cold/directional/north,
/turf/open/floor/iron/colony/bolts,
/area/shuttle/salvaged_shuttle)
"Jd" = (
/obj/structure/marker_beacon/jade,
/turf/closed/wall/mineral/nanocarbon/black,
/area/shuttle/salvaged_shuttle)
"Kv" = (
/obj/machinery/power/shuttle_engine/propulsion{
	dir = 8
	},
/turf/open/floor/plating,
/area/shuttle/salvaged_shuttle)
"KV" = (
/obj/structure/railing/eva_handhold/directional/south,
/obj/effect/mapping_helpers/salvage_anchor/end/one,
/turf/closed/wall/mineral/nanocarbon/black,
/area/shuttle/salvaged_shuttle)
"LH" = (
/obj/structure/railing/eva_handhold/directional/north,
/obj/effect/mapping_helpers/salvage_anchor/end/eight,
/turf/closed/wall/mineral/nanocarbon/black,
/area/shuttle/salvaged_shuttle)
"LJ" = (
/obj/effect/mapping_helpers/salvage_anchor/end/three,
/turf/closed/wall/mineral/nanocarbon/black,
/area/shuttle/salvaged_shuttle)
"LK" = (
/obj/machinery/power/micro_reactor,
/turf/open/floor/plating,
/area/shuttle/salvaged_shuttle)
"LV" = (
/obj/effect/mapping_helpers/salvage_anchor/end/six,
/turf/closed/wall/mineral/nanocarbon/black,
/area/shuttle/salvaged_shuttle)
"Md" = (
/obj/structure/railing/eva_handhold/directional/south,
/obj/effect/mapping_helpers/salvage_anchor/end/two,
/turf/closed/wall/mineral/nanocarbon/yellow,
/area/shuttle/salvaged_shuttle)
"MV" = (
/obj/docking_port/mobile/salvage,
/obj/structure/railing/eva_handhold/directional/south,
/obj/structure/railing/eva_handhold/directional/north,
/obj/structure/marker_beacon/yellow,
/turf/open/floor/engine/anchor_jack,
/area/shuttle/salvaged_shuttle)
"Ow" = (
/obj/machinery/light/blacklight/directional/north,
/turf/open/floor/iron/colony,
/area/shuttle/salvaged_shuttle)
"Pp" = (
/obj/structure/chair/comfy/shuttle{
	dir = 4
	},
/obj/machinery/light/cold/directional/south,
/turf/open/floor/iron/colony/bolts,
/area/shuttle/salvaged_shuttle)
"QT" = (
/obj/structure/railing/eva_handhold/directional/north,
/turf/closed/wall/mineral/nanocarbon/yellow,
/area/shuttle/salvaged_shuttle)
"RM" = (
/obj/structure/chair/comfy/shuttle{
	dir = 4
	},
/obj/machinery/light/cold/directional/north,
/turf/open/floor/iron/colony/bolts,
/area/shuttle/salvaged_shuttle)
"RS" = (
/turf/closed/wall/mineral/nanocarbon/black,
/area/shuttle/salvaged_shuttle)
"Sv" = (
/obj/structure/railing/eva_handhold/directional/south,
/obj/structure/railing/eva_handhold/directional/north,
/obj/effect/mapping_helpers/salvage_anchor/eight,
/obj/structure/marker_beacon/jade,
/turf/open/floor/engine/anchor_jack,
/area/shuttle/salvaged_shuttle)
"UU" = (
/turf/closed/wall/mineral/aluminum,
/area/shuttle/salvaged_shuttle)
"Yj" = (
/obj/machinery/portable_atmospherics/canister/freon,
/turf/open/floor/plating,
/area/shuttle/salvaged_shuttle)
"YC" = (
/turf/template_noop,
/area/template_noop)
"YR" = (
/obj/structure/marker_beacon/burgundy,
/turf/closed/wall/mineral/nanocarbon/black,
/area/shuttle/salvaged_shuttle)

(1,1,1) = {"
YC
YC
YC
YC
YC
YC
YC
YC
YC
YC
YC
YC
YC
YC
YC
YC
YC
YC
YC
"}
(2,1,1) = {"
YC
YC
YC
YC
YC
YC
YC
YC
YC
YC
YC
YC
YC
YC
YC
YC
YC
YC
YC
"}
(3,1,1) = {"
YC
YC
YC
YC
YC
YC
YC
YC
YC
YC
YC
YC
YC
YC
YC
YC
YC
YC
YC
"}
(4,1,1) = {"
YC
Sv
YC
YC
YC
YC
YC
YC
YC
YC
YC
YC
YC
YC
YC
YC
YC
Ii
YC
"}
(5,1,1) = {"
YC
YC
YC
YC
YC
YC
YC
YC
YC
YC
YC
YC
YC
YC
YC
YC
YC
YC
YC
"}
(6,1,1) = {"
YC
YC
YC
YC
YC
YC
YC
YC
YC
YC
YC
YC
YC
YC
YC
YC
YC
YC
YC
"}
(7,1,1) = {"
YC
YC
YC
YC
YC
YC
YC
Jd
RS
Kv
RS
YR
YC
YC
YC
YC
YC
YC
YC
"}
(8,1,1) = {"
YC
HR
YC
YC
YC
UU
YC
LH
mH
nw
mH
KV
YC
UU
YC
YC
YC
HR
YC
"}
(9,1,1) = {"
YC
YC
YC
YC
YC
UU
YC
RS
Ow
LK
BW
RS
YC
UU
YC
YC
YC
YC
YC
"}
(10,1,1) = {"
YC
YC
YC
YC
YC
Ew
RS
CU
UU
nP
UU
CU
RS
kZ
YC
YC
YC
YC
YC
"}
(11,1,1) = {"
YC
YC
YC
YC
YC
zd
yZ
UU
IG
kO
Im
UU
yZ
jv
YC
YC
YC
YC
YC
"}
(12,1,1) = {"
uk
YC
YC
YC
YC
ez
yi
tC
CO
kO
CC
tC
yi
ez
YC
YC
YC
YC
vE
"}
(13,1,1) = {"
YC
YC
YC
YC
YC
yx
yi
tC
mH
CC
mH
tC
yi
Md
YC
YC
YC
YC
YC
"}
(14,1,1) = {"
YC
YC
YC
YC
YC
zd
ce
tC
CC
kO
CC
tC
yi
jv
YC
YC
YC
YC
YC
"}
(15,1,1) = {"
YC
YC
YC
YC
YC
RS
yi
UU
IZ
kO
Im
UU
yi
RS
YC
YC
YC
YC
YC
"}
(16,1,1) = {"
HR
YC
YC
YC
YC
QT
UU
UU
UU
BV
UU
UU
IM
ym
YC
YC
YC
YC
MV
"}
(17,1,1) = {"
YC
YC
YC
YC
YC
zm
pH
zm
CC
kO
CC
UU
yi
ez
YC
YC
YC
YC
YC
"}
(18,1,1) = {"
YC
YC
YC
YC
YC
zd
UU
UU
IG
kO
Im
UU
yi
jv
YC
YC
YC
YC
YC
"}
(19,1,1) = {"
YC
YC
YC
YC
YC
LV
yi
UU
UU
nP
UU
UU
IM
LJ
YC
YC
YC
YC
YC
"}
(20,1,1) = {"
Dm
YC
YC
YC
YC
QT
Yj
UU
CC
kO
CC
UU
yi
ym
YC
YC
YC
YC
Em
"}
(21,1,1) = {"
YC
YC
YC
YC
YC
oM
ez
CU
RM
kO
Pp
CU
ez
fI
YC
YC
YC
YC
YC
"}
(22,1,1) = {"
YC
YC
YC
YC
YC
YC
Du
RS
IP
CC
IP
RS
Du
YC
YC
YC
YC
YC
YC
"}
(23,1,1) = {"
YC
YC
YC
YC
YC
ez
Du
Jd
RS
tC
RS
YR
Du
RS
YC
YC
YC
YC
YC
"}
(24,1,1) = {"
YC
HR
YC
YC
YC
Dp
Du
YC
YC
YC
YC
YC
Du
Av
YC
YC
YC
HR
YC
"}
(25,1,1) = {"
YC
YC
YC
YC
YC
ez
ez
YC
YC
YC
YC
YC
RS
RS
YC
YC
YC
YC
YC
"}
(26,1,1) = {"
YC
YC
YC
YC
YC
YC
YC
YC
YC
YC
YC
YC
YC
YC
YC
YC
YC
YC
YC
"}
(27,1,1) = {"
YC
YC
YC
YC
YC
YC
YC
YC
YC
YC
YC
YC
YC
YC
YC
YC
YC
YC
YC
"}
(28,1,1) = {"
YC
dD
YC
YC
YC
YC
YC
YC
YC
YC
YC
YC
YC
YC
YC
YC
YC
Ev
YC
"}
(29,1,1) = {"
YC
YC
YC
YC
YC
YC
YC
YC
YC
YC
YC
YC
YC
YC
YC
YC
YC
YC
YC
"}
(30,1,1) = {"
YC
YC
YC
YC
YC
YC
YC
YC
YC
YC
YC
YC
YC
YC
YC
YC
YC
YC
YC
"}
(31,1,1) = {"
YC
YC
YC
YC
YC
YC
YC
YC
YC
YC
YC
YC
YC
YC
YC
YC
YC
YC
YC
"}
