//MAP CONVERTED BY dmm2tgm.py THIS HEADER COMMENT PREVENTS RECONVERSION, DO NOT REMOVE
"a" = (
/obj/machinery/exoscanner/shuttle_part/radar_panel/directional/east,
/turf/closed/wall/mineral/nanocarbon{
	color = #FF6821
	},
/area/shuttle/arrival)
"b" = (
/obj/structure/railing{
	dir = 4
	},
/obj/structure/railing{
	dir = 8
	},
/turf/open/floor/iron/colony/texture/nanocarbon,
/area/shuttle/arrival)
"c" = (
/obj/effect/turf_decal/trimline/brown,
/turf/open/floor/iron/colony/nanocarbon,
/area/shuttle/arrival)
"d" = (
/obj/structure/shuttle_decoration/radiator{
	dir = 1
	},
/turf/closed/wall/mineral/nanocarbon/nodiagonal/black,
/area/shuttle/arrival)
"e" = (
/obj/machinery/digital_clock/directional/north,
/obj/structure/shelf,
/turf/open/floor/pod,
/area/shuttle/arrival)
"f" = (
/obj/machinery/exoscanner/shuttle_part/sensors_blister/directional/east,
/turf/closed/wall/mineral/nanocarbon{
	color = #FF6821
	},
/area/shuttle/arrival)
"g" = (
/obj/structure/shuttle_decoration/wall_plate/gold_foil{
	dir = 8
	},
/turf/closed/wall/mineral/aluminum,
/area/shuttle/arrival)
"h" = (
/obj/machinery/power/shuttle_engine/propulsion{
	dir = 8
	},
/obj/structure/engine_covers/thruster_nozzle{
	dir = 8
	},
/turf/open/floor/plating/nanocarbon,
/area/shuttle/arrival)
"i" = (
/obj/structure/chair/comfy/shuttle{
	dir = 8
	},
/obj/machinery/light/cold/dim/directional/north,
/turf/open/floor/pod,
/area/shuttle/arrival)
"j" = (
/obj/structure/shuttle_decoration/rcs/directional/south,
/turf/closed/wall/mineral/nanocarbon/nodiagonal,
/area/shuttle/arrival)
"k" = (
/obj/structure/shuttle_decoration/rcs/directional/south,
/obj/machinery/exoscanner/shuttle_part/radio_dish/directional/east,
/turf/closed/wall/mineral/nanocarbon/nodiagonal,
/area/shuttle/arrival)
"l" = (
/obj/machinery/door/airlock/shuttle/glass,
/turf/open/floor/iron/colony/texture/nanocarbon,
/area/shuttle/arrival)
"m" = (
/obj/structure/shuttle_decoration/radiator,
/turf/closed/wall/mineral/nanocarbon/nodiagonal/black,
/area/shuttle/arrival)
"n" = (
/obj/structure/chair/comfy/shuttle{
	dir = 4
	},
/turf/open/floor/pod,
/area/shuttle/arrival)
"o" = (
/obj/machinery/power/shuttle_engine/propulsion{
	dir = 8
	},
/obj/structure/engine_covers/thruster_nozzle{
	dir = 8
	},
/obj/docking_port/mobile/arrivals{
	dir = 4
	},
/turf/open/floor/plating/nanocarbon,
/area/shuttle/arrival)
"p" = (
/obj/structure/shuttle_decoration/wall_plate/nanocarbon{
	dir = 6;
	color = "#FF6821"
	},
/obj/structure/shuttle_decoration/bullbar/directional/east,
/obj/structure/shuttle_decoration/headlight/directional/east,
/turf/closed/wall/mineral/nanocarbon/nodiagonal,
/area/shuttle/arrival)
"q" = (
/turf/open/floor/plating/nanocarbon,
/area/shuttle/arrival)
"r" = (
/obj/structure/shuttle_decoration/wall_plate/nanocarbon{
	dir = 1;
	color = "#FF6821"
	},
/turf/closed/wall/mineral/nanocarbon{
	color = #FF6821
	},
/area/shuttle/arrival)
"s" = (
/obj/structure/shuttle_decoration/wall_plate/gold_foil,
/turf/closed/wall/mineral/nanocarbon/nodiagonal/black,
/area/shuttle/arrival)
"t" = (
/obj/structure/closet/firecloset/full,
/obj/item/storage/medkit/emergency,
/turf/open/floor/pod,
/area/shuttle/arrival)
"u" = (
/obj/structure/shuttle_decoration/wall_plate/gold_foil{
	dir = 1
	},
/turf/closed/wall/mineral/nanocarbon/nodiagonal/black,
/area/shuttle/arrival)
"v" = (
/obj/structure/chair/comfy/shuttle{
	dir = 4
	},
/obj/machinery/light/cold/dim/directional/south,
/turf/open/floor/pod,
/area/shuttle/arrival)
"w" = (
/turf/template_noop,
/area/template_noop)
"x" = (
/obj/structure/fluff/tram_rail{
	dir = 1;
	name = "long-range antenna";
	desc = null
	},
/obj/structure/fluff/tram_rail/end{
	name = "long-range antenna";
	desc = null
	},
/turf/template_noop,
/area/shuttle/arrival)
"y" = (
/obj/structure/railing{
	dir = 1
	},
/obj/structure/railing,
/turf/open/floor/iron/colony/texture/nanocarbon,
/area/shuttle/arrival)
"z" = (
/obj/structure/shuttle_decoration/rcs/directional/north,
/turf/closed/wall/mineral/nanocarbon/nodiagonal,
/area/shuttle/arrival)
"A" = (
/turf/closed/wall/mineral/aluminum,
/area/shuttle/arrival)
"B" = (
/obj/structure/window/fulltile/salvage_shuttle,
/obj/structure/fans/tiny/invisible,
/turf/open/floor/plating/airless,
/area/shuttle/arrival)
"C" = (
/obj/structure/fluff{
	icon = 'icons/mob/simple/hivebot.dmi';
	icon_state = "def_radar-off";
	name = "CAS 'Guppy'";
	desc = "A large dome-shaped structure that contains all the vital components to safely pilot an automated transport shuttle. Contains a simple-minded drone AI and a blackbox."s"
	},
/turf/open/floor/plating/nanocarbon,
/area/shuttle/arrival)
"D" = (
/obj/structure/closet/wardrobe/mixed,
/obj/machinery/light/cold/dim/directional/north,
/turf/open/floor/pod,
/area/shuttle/arrival)
"E" = (
/obj/machinery/power/shuttle_engine/heater{
	dir = 8
	},
/obj/structure/engine_covers/heater_cover{
	dir = 4
	},
/turf/open/floor/plating/nanocarbon,
/area/shuttle/arrival)
"F" = (
/obj/structure/fluff/tram_rail/anchor{
	desc = "Great for transport shuttles, not so great for much else.";
	name = "long-range antenna anchor"
	},
/obj/structure/fluff/tram_rail/anchor{
	dir = 1;
	desc = "Great for transport shuttles, not so great for much else.";
	name = "long-range antenna anchor"
	},
/turf/open/floor/plating/nanocarbon,
/area/shuttle/arrival)
"G" = (
/obj/structure/closet/emcloset,
/obj/item/storage/medkit,
/turf/open/floor/pod,
/area/shuttle/arrival)
"H" = (
/obj/structure/shuttle_access_panel,
/turf/open/floor/iron/colony/texture/nanocarbon,
/area/shuttle/arrival)
"I" = (
/obj/structure/shuttle_decoration/landing_engine/directional/south,
/turf/closed/wall/mineral/nanocarbon/nodiagonal,
/area/shuttle/arrival)
"J" = (
/obj/structure/railing/corner/end{
	dir = 8
	},
/obj/structure/railing/corner/end{
	dir = 4
	},
/obj/structure/railing/corner/end/flip{
	dir = 4
	},
/obj/structure/railing/corner/end/flip{
	dir = 8
	},
/turf/open/floor/iron/colony/texture/nanocarbon,
/area/shuttle/arrival)
"K" = (
/obj/structure/railing/corner,
/obj/structure/railing/corner{
	dir = 4
	},
/obj/structure/railing/corner{
	dir = 8
	},
/obj/item/radio/intercom/directional/south,
/obj/structure/railing/corner{
	dir = 1
	},
/turf/open/floor/iron/colony/bolts/nanocarbon,
/area/shuttle/arrival)
"L" = (
/obj/machinery/light/small/red/dim/directional/east,
/turf/open/floor/plating/nanocarbon,
/area/shuttle/arrival)
"M" = (
/turf/closed/wall/mineral/nanocarbon/nodiagonal,
/area/shuttle/arrival)
"N" = (
/turf/closed/wall/mineral/nanocarbon{
	color = #FF6821
	},
/area/shuttle/arrival)
"O" = (
/obj/structure/railing,
/obj/structure/railing{
	dir = 1
	},
/turf/open/floor/iron/colony/texture/nanocarbon,
/area/shuttle/arrival)
"P" = (
/obj/structure/shuttle_decoration/wall_plate/armor{
	dir = 9
	},
/turf/closed/wall/mineral/nanocarbon/nodiagonal/black,
/area/shuttle/arrival)
"Q" = (
/obj/structure/chair/comfy/shuttle{
	dir = 8
	},
/turf/open/floor/pod,
/area/shuttle/arrival)
"S" = (
/obj/structure/shuttle_access_panel,
/turf/open/floor/plating/nanocarbon,
/area/shuttle/arrival)
"T" = (
/obj/structure/shuttle_decoration/wall_plate/armor{
	dir = 10
	},
/turf/closed/wall/mineral/nanocarbon/nodiagonal/black,
/area/shuttle/arrival)
"U" = (
/obj/structure/fluff/tram_rail/end{
	dir = 1;
	name = "long-range antenna";
	desc = null
	},
/turf/template_noop,
/area/shuttle/arrival)
"V" = (
/obj/structure/shuttle_decoration/wall_plate/nanocarbon{
	dir = 5;
	color = "#FF6821"
	},
/obj/structure/shuttle_decoration/bullbar/directional/east,
/obj/structure/shuttle_decoration/headlight/directional/east,
/turf/closed/wall/mineral/nanocarbon/nodiagonal,
/area/shuttle/arrival)
"W" = (
/obj/structure/shuttle_decoration/landing_engine/directional/north,
/turf/closed/wall/mineral/nanocarbon/nodiagonal,
/area/shuttle/arrival)
"X" = (
/obj/structure/shuttle_decoration/wall_plate/nanocarbon{
	color = "#FF6821"
	},
/turf/closed/wall/mineral/nanocarbon{
	color = #FF6821
	},
/area/shuttle/arrival)
"Y" = (
/obj/structure/chair/comfy/shuttle{
	dir = 8
	},
/obj/machinery/light/cold/dim/directional/south,
/turf/open/floor/pod,
/area/shuttle/arrival)
"Z" = (
/obj/structure/shuttle_decoration/wall_plate/nanocarbon{
	dir = 4;
	color = "#FF6821"
	},
/turf/closed/wall/mineral/nanocarbon{
	color = #FF6821
	},
/area/shuttle/arrival)

(1,1,1) = {"
w
P
h
o
h
T
w
"}
(2,1,1) = {"
w
d
E
E
E
m
w
"}
(3,1,1) = {"
z
s
q
q
L
u
j
"}
(4,1,1) = {"
W
A
g
S
g
A
I
"}
(5,1,1) = {"
N
D
t
O
n
v
N
"}
(6,1,1) = {"
B
c
c
J
c
c
B
"}
(7,1,1) = {"
N
e
G
y
Q
Q
N
"}
(8,1,1) = {"
l
b
b
K
A
A
N
"}
(9,1,1) = {"
N
n
n
y
n
n
N
"}
(10,1,1) = {"
B
c
c
J
c
c
B
"}
(11,1,1) = {"
N
i
Q
O
Q
Y
N
"}
(12,1,1) = {"
W
f
M
H
M
a
I
"}
(13,1,1) = {"
z
w
r
C
X
F
k
"}
(14,1,1) = {"
w
w
V
Z
p
x
w
"}
(15,1,1) = {"
w
w
w
w
w
U
w
"}
