//MAP CONVERTED BY dmm2tgm.py THIS HEADER COMMENT PREVENTS RECONVERSION, DO NOT REMOVE
"a" = (
/turf/open/openspace/icemoon,
/area/ruin/unpowered/primitive_genemod_den)
"c" = (
/obj/effect/turf_decal/siding/wood,
/obj/effect/turf_decal/weather/snow/corner{
	dir = 1
	},
/turf/open/misc/sandy_dirt/icemoon,
/area/ruin/unpowered/primitive_genemod_den)
"d" = (
/turf/open/misc/asteroid/snow/icemoon,
/area/ruin/unpowered/primitive_genemod_den)
"f" = (
/obj/effect/turf_decal/weather/snow/corner{
	dir = 5
	},
/turf/open/openspace/icemoon,
/area/ruin/unpowered/primitive_genemod_den)
"g" = (
/obj/effect/turf_decal/weather/snow/corner{
	dir = 5
	},
/obj/effect/turf_decal/weather/snow/corner,
/turf/open/openspace/icemoon,
/area/ruin/unpowered/primitive_genemod_den)
"h" = (
/obj/structure/statue/hearthkin/odin,
/obj/structure/railing/wooden_fencing,
/obj/structure/railing/wooden_fencing{
	dir = 4
	},
/turf/open/floor/stone/icemoon,
/area/ruin/unpowered/primitive_genemod_den)
"i" = (
/turf/closed/wall/mineral/stone,
/area/ruin/unpowered/primitive_genemod_den)
"k" = (
/obj/structure/flora/rock/pile/icy/style_random,
/turf/open/misc/asteroid/snow/icemoon,
/area/ruin/unpowered/primitive_genemod_den)
"l" = (
/obj/effect/turf_decal/siding/wood{
	dir = 8
	},
/turf/open/misc/asteroid/snow/icemoon,
/area/ruin/unpowered/primitive_genemod_den)
"m" = (
/obj/effect/turf_decal/weather/snow/corner{
	dir = 6
	},
/turf/open/misc/sandy_dirt/icemoon,
/area/ruin/unpowered/primitive_genemod_den)
"n" = (
/obj/effect/turf_decal/weather/snow/corner{
	dir = 5
	},
/turf/open/misc/sandy_dirt/icemoon,
/area/ruin/unpowered/primitive_genemod_den)
"o" = (
/obj/effect/turf_decal/weather/snow/corner{
	dir = 10
	},
/turf/open/openspace/icemoon,
/area/ruin/unpowered/primitive_genemod_den)
"p" = (
/turf/open/floor/stone/icemoon,
/area/ruin/unpowered/primitive_genemod_den)
"r" = (
/obj/effect/turf_decal/weather/snow/corner{
	dir = 4
	},
/turf/open/openspace/icemoon,
/area/ruin/unpowered/primitive_genemod_den)
"s" = (
/obj/effect/turf_decal/weather/snow/corner{
	dir = 6
	},
/turf/open/openspace/icemoon,
/area/ruin/unpowered/primitive_genemod_den)
"t" = (
/obj/effect/turf_decal/siding/wood/corner,
/obj/effect/turf_decal/weather/snow/corner{
	dir = 10
	},
/turf/open/misc/sandy_dirt/icemoon,
/area/ruin/unpowered/primitive_genemod_den)
"v" = (
/obj/effect/turf_decal/siding/wood{
	dir = 4
	},
/turf/open/misc/asteroid/snow/icemoon,
/area/ruin/unpowered/primitive_genemod_den)
"w" = (
/obj/effect/turf_decal/weather/snow/corner{
	dir = 9
	},
/turf/open/misc/sandy_dirt/icemoon,
/area/ruin/unpowered/primitive_genemod_den)
"x" = (
/obj/structure/mineral_door/wood/large_gate{
	dir = 1
	},
/turf/open/floor/stone/icemoon,
/area/ruin/unpowered/primitive_genemod_den)
"y" = (
/obj/effect/turf_decal/siding/wood{
	dir = 1
	},
/turf/open/misc/asteroid/snow/icemoon,
/area/ruin/unpowered/primitive_genemod_den)
"z" = (
/obj/effect/turf_decal/siding/wood/corner{
	dir = 4
	},
/turf/open/misc/asteroid/snow/icemoon,
/area/ruin/unpowered/primitive_genemod_den)
"A" = (
/obj/effect/turf_decal/weather/snow/corner{
	dir = 1
	},
/turf/open/misc/sandy_dirt/icemoon,
/area/ruin/unpowered/primitive_genemod_den)
"C" = (
/obj/effect/turf_decal/weather/snow/corner{
	dir = 9
	},
/obj/effect/turf_decal/weather/snow/corner,
/turf/open/misc/sandy_dirt/icemoon,
/area/ruin/unpowered/primitive_genemod_den)
"D" = (
/obj/effect/turf_decal/weather/snow/corner{
	dir = 8
	},
/turf/open/openspace/icemoon,
/area/ruin/unpowered/primitive_genemod_den)
"E" = (
/obj/effect/turf_decal/weather/snow/corner{
	dir = 9
	},
/obj/effect/turf_decal/weather/snow/corner{
	dir = 6
	},
/turf/open/misc/sandy_dirt/icemoon,
/area/ruin/unpowered/primitive_genemod_den)
"F" = (
/obj/effect/turf_decal/siding/wood/corner{
	dir = 8
	},
/obj/effect/turf_decal/weather/snow/corner{
	dir = 6
	},
/turf/open/misc/sandy_dirt/icemoon,
/area/ruin/unpowered/primitive_genemod_den)
"G" = (
/obj/effect/turf_decal/weather/snow/corner{
	dir = 4
	},
/turf/open/misc/sandy_dirt/icemoon,
/area/ruin/unpowered/primitive_genemod_den)
"I" = (
/turf/open/misc/grass/roofing,
/area/ruin/unpowered/primitive_genemod_den)
"J" = (
/obj/effect/turf_decal/weather/snow/corner{
	dir = 10
	},
/turf/open/misc/sandy_dirt/icemoon,
/area/ruin/unpowered/primitive_genemod_den)
"K" = (
/obj/structure/statue/hearthkin/odin,
/obj/structure/railing/wooden_fencing{
	dir = 8
	},
/obj/structure/railing/wooden_fencing,
/turf/open/floor/stone/icemoon,
/area/ruin/unpowered/primitive_genemod_den)
"L" = (
/obj/effect/turf_decal/siding/wood/corner{
	dir = 1
	},
/turf/open/misc/asteroid/snow/icemoon,
/area/ruin/unpowered/primitive_genemod_den)
"M" = (
/obj/effect/turf_decal/weather/snow/corner{
	dir = 9
	},
/obj/effect/turf_decal/weather/snow/corner{
	dir = 4
	},
/turf/open/misc/sandy_dirt/icemoon,
/area/ruin/unpowered/primitive_genemod_den)
"N" = (
/obj/structure/mineral_door/wood/large_gate,
/turf/open/floor/stone/icemoon,
/area/ruin/unpowered/primitive_genemod_den)
"P" = (
/turf/closed/mineral/snowmountain/cavern/icemoon,
/area/ruin/unpowered/primitive_genemod_den)
"Q" = (
/turf/closed/wall/mineral/wood/nonmetal,
/area/ruin/unpowered/primitive_genemod_den)
"S" = (
/obj/effect/turf_decal/weather/snow/corner{
	dir = 6
	},
/obj/effect/turf_decal/weather/snow/corner{
	dir = 9
	},
/turf/open/misc/sandy_dirt/icemoon,
/area/ruin/unpowered/primitive_genemod_den)
"T" = (
/obj/effect/turf_decal/weather/snow/corner{
	dir = 9
	},
/turf/open/openspace/icemoon,
/area/ruin/unpowered/primitive_genemod_den)
"V" = (
/obj/effect/turf_decal/weather/snow/corner{
	dir = 1
	},
/turf/open/openspace/icemoon,
/area/ruin/unpowered/primitive_genemod_den)
"X" = (
/obj/structure/flora/tree/pine/style_random,
/turf/open/misc/asteroid/snow/icemoon,
/area/ruin/unpowered/primitive_genemod_den)
"Y" = (
/obj/effect/turf_decal/weather/snow/corner,
/turf/open/openspace/icemoon,
/area/ruin/unpowered/primitive_genemod_den)

(1,1,1) = {"
d
X
d
d
d
d
d
a
a
a
a
a
a
a
a
a
Y
d
d
d
d
P
d
d
d
P
P
d
d
d
d
d
d
d
d
d
d
X
d
d
d
d
d
d
d
X
d
d
P
P
"}
(2,1,1) = {"
d
d
d
X
d
d
a
a
a
a
a
a
a
a
a
a
a
o
d
d
d
d
P
P
P
P
d
d
d
X
d
d
d
d
d
d
d
d
d
d
d
d
X
d
d
d
P
P
P
P
"}
(3,1,1) = {"
d
d
d
a
a
a
a
a
a
a
a
a
a
a
a
a
a
a
o
d
P
d
P
P
P
P
P
P
P
d
d
T
D
D
D
D
D
D
P
d
d
d
d
d
d
P
P
P
P
P
"}
(4,1,1) = {"
X
d
a
a
a
a
a
a
a
a
a
a
a
a
a
a
a
a
a
o
d
P
P
P
P
d
P
P
d
d
T
a
a
a
a
a
a
a
a
P
d
P
d
d
d
d
P
P
P
P
"}
(5,1,1) = {"
d
a
a
a
a
a
a
a
a
a
a
a
a
a
a
a
a
a
a
a
D
a
a
Y
d
d
P
d
d
T
a
a
a
a
a
a
a
a
a
a
D
P
P
P
d
d
d
P
d
P
"}
(6,1,1) = {"
a
a
a
a
a
a
a
I
I
I
I
a
a
a
a
a
a
a
a
a
a
a
a
a
o
d
P
P
d
a
a
a
a
a
a
a
a
a
a
a
a
a
P
P
d
d
d
d
d
d
"}
(7,1,1) = {"
a
a
a
a
a
a
I
I
I
I
I
I
a
a
a
a
a
a
a
a
a
a
a
a
a
o
d
P
D
a
a
a
a
a
a
a
a
a
a
a
a
a
a
P
P
d
d
d
d
d
"}
(8,1,1) = {"
a
a
a
a
a
I
I
I
I
I
I
I
I
a
a
a
a
a
a
a
a
a
a
a
a
a
D
a
a
a
a
a
a
a
a
a
a
a
a
a
a
a
Y
d
P
P
Q
Q
Q
d
"}
(9,1,1) = {"
a
a
a
a
a
I
I
I
I
I
I
I
I
a
a
a
a
a
a
a
a
a
a
a
a
a
a
a
a
a
a
a
a
a
a
a
a
a
a
a
a
a
a
J
d
d
d
Q
i
d
"}
(10,1,1) = {"
a
a
a
a
a
I
I
I
I
I
I
I
I
a
a
a
a
a
a
a
a
a
a
a
a
a
a
a
a
a
a
a
a
a
a
a
a
a
a
a
a
a
a
G
J
d
d
i
i
d
"}
(11,1,1) = {"
a
a
a
a
a
I
I
I
I
I
I
I
I
a
a
a
a
a
a
a
a
a
a
a
a
a
a
a
a
a
a
a
a
a
a
a
a
a
a
a
a
a
Y
d
n
t
v
i
K
z
"}
(12,1,1) = {"
a
a
a
a
a
I
I
I
I
I
I
I
I
a
a
a
a
a
a
a
a
a
a
a
a
a
a
a
a
a
a
a
a
a
a
a
a
a
a
a
a
a
Y
d
k
c
p
p
N
y
"}
(13,1,1) = {"
a
a
a
a
a
I
I
I
I
I
I
I
I
a
a
a
a
a
a
a
a
a
a
a
a
a
a
a
a
a
a
a
a
a
a
a
a
a
a
a
a
a
s
d
d
c
p
p
x
y
"}
(14,1,1) = {"
a
a
a
a
a
I
I
I
I
I
I
I
I
a
a
a
a
a
a
a
a
a
a
a
a
a
a
a
a
a
a
a
a
a
a
a
a
a
a
a
a
s
d
d
w
F
l
i
h
L
"}
(15,1,1) = {"
a
a
a
a
a
I
I
I
I
I
I
I
I
a
a
a
a
a
a
a
a
a
a
a
a
a
a
a
a
a
a
a
a
a
a
a
a
a
a
a
s
d
d
M
m
d
d
i
i
d
"}
(16,1,1) = {"
a
a
a
a
a
I
I
I
I
I
I
I
I
a
a
a
a
a
a
a
a
a
a
a
a
a
a
a
a
a
a
a
a
a
a
a
a
a
a
s
d
d
E
d
d
d
d
Q
i
d
"}
(17,1,1) = {"
a
a
a
a
a
I
I
I
I
I
I
I
I
a
a
a
a
a
a
a
a
a
a
a
a
a
a
a
a
a
a
a
a
a
a
a
a
a
Y
d
d
d
d
P
P
P
Q
Q
Q
d
"}
(18,1,1) = {"
a
a
a
a
a
I
I
I
I
I
I
I
I
a
a
a
a
a
a
a
a
a
a
a
a
a
a
a
a
a
a
a
a
a
a
a
a
a
s
d
d
E
P
P
P
d
d
d
d
d
"}
(19,1,1) = {"
a
a
a
a
a
I
I
I
I
I
I
I
I
a
a
a
a
a
a
a
a
a
a
a
a
a
a
a
a
a
a
a
a
a
a
a
a
Y
d
d
d
P
P
P
d
d
X
d
d
a
"}
(20,1,1) = {"
a
a
a
a
a
I
I
I
I
I
I
I
I
a
a
a
a
a
a
a
a
a
a
a
a
a
a
a
a
a
a
a
a
a
a
a
a
Y
d
d
d
P
P
P
P
d
d
d
P
a
"}
(21,1,1) = {"
a
a
a
a
a
I
I
I
I
I
I
I
I
a
a
a
a
a
a
a
a
a
a
a
a
a
a
a
a
a
a
a
a
a
a
a
a
Y
d
d
P
P
P
P
P
P
d
P
a
P
"}
(22,1,1) = {"
a
a
a
a
a
I
I
I
I
I
I
I
I
a
a
a
a
a
a
a
a
a
a
a
a
a
a
a
a
a
a
a
a
a
a
a
a
Y
d
d
P
P
P
P
P
P
P
P
P
P
"}
(23,1,1) = {"
a
a
a
a
a
I
I
I
I
I
I
I
I
a
a
a
a
a
a
a
a
a
a
a
a
a
a
a
a
a
a
a
a
a
a
a
a
Y
d
d
P
P
P
P
P
P
P
P
P
P
"}
(24,1,1) = {"
a
a
a
a
a
I
I
I
I
I
I
I
I
a
a
a
a
a
a
a
a
a
a
a
a
a
a
a
a
a
a
a
a
a
a
a
a
Y
d
d
P
P
P
P
P
P
P
P
P
P
"}
(25,1,1) = {"
a
a
a
a
a
I
I
I
I
I
I
I
I
a
a
a
a
a
a
a
a
a
a
a
a
a
a
a
a
a
a
a
a
a
a
a
a
Y
d
d
d
P
P
P
P
P
P
P
P
P
"}
(26,1,1) = {"
a
a
a
a
a
I
I
I
I
I
I
I
I
a
a
a
a
a
a
a
a
a
a
a
a
a
a
a
a
a
a
a
a
a
a
a
a
Y
d
d
d
P
P
P
P
P
P
P
P
P
"}
(27,1,1) = {"
a
a
a
a
a
I
I
I
I
I
I
I
I
a
a
a
a
a
a
a
a
a
a
a
a
a
a
a
a
a
a
a
a
a
a
a
a
Y
d
d
d
d
P
P
P
P
P
P
P
P
"}
(28,1,1) = {"
a
a
a
a
a
I
I
I
I
I
I
I
I
a
a
a
a
a
a
a
a
a
a
a
a
a
a
a
a
a
a
a
a
a
a
a
a
a
o
d
d
d
d
P
P
P
P
P
P
P
"}
(29,1,1) = {"
a
a
a
a
a
a
I
I
I
I
I
I
a
a
a
a
a
a
a
a
a
a
a
a
a
a
a
a
a
a
a
a
a
a
a
a
a
a
a
o
d
d
d
d
P
P
P
P
P
P
"}
(30,1,1) = {"
a
a
a
a
a
a
a
I
I
I
I
a
a
a
a
a
a
a
a
a
a
a
a
a
a
a
a
a
a
a
a
a
a
a
a
a
a
a
a
a
o
d
d
S
d
d
P
P
P
P
"}
(31,1,1) = {"
a
a
a
a
a
a
a
a
a
a
a
a
a
a
a
a
a
a
a
a
a
a
a
a
a
a
a
a
a
a
a
a
a
a
a
a
a
a
a
a
a
P
d
d
d
d
P
P
P
P
"}
(32,1,1) = {"
a
a
a
a
a
a
a
a
a
a
a
a
a
a
a
a
a
a
a
a
a
a
a
a
a
a
a
a
a
a
a
a
a
a
a
a
a
a
a
a
a
a
o
d
d
S
d
P
P
a
"}
(33,1,1) = {"
a
a
a
a
a
a
a
a
a
a
a
a
a
a
a
a
a
a
a
a
a
a
a
a
a
a
a
a
a
a
a
a
a
a
a
a
a
a
a
a
a
a
Y
d
d
d
d
P
P
a
"}
(34,1,1) = {"
a
a
a
a
a
a
a
a
a
a
a
a
a
a
a
a
a
a
a
a
a
a
a
a
a
a
a
a
a
a
a
a
a
a
a
a
a
a
a
a
a
a
P
d
E
d
d
P
P
a
"}
(35,1,1) = {"
a
a
a
a
a
a
a
a
a
a
a
a
a
a
a
a
a
a
a
a
a
a
a
a
a
a
a
a
a
a
a
a
a
a
a
a
a
a
a
a
a
a
P
d
d
d
P
P
P
a
"}
(36,1,1) = {"
a
a
a
a
a
a
a
a
a
a
a
a
a
a
a
a
a
a
a
a
a
a
a
a
a
a
a
a
a
a
a
a
a
a
a
a
a
a
a
a
a
Y
d
d
E
d
P
P
P
P
"}
(37,1,1) = {"
a
a
a
a
a
a
a
a
a
a
a
a
a
a
a
a
a
a
a
a
a
a
a
a
a
a
a
a
a
a
a
a
a
a
a
a
a
a
a
a
r
P
d
C
d
d
P
P
P
P
"}
(38,1,1) = {"
a
a
a
a
a
a
a
a
a
a
a
a
a
a
a
a
a
a
a
a
a
a
a
a
a
a
a
a
a
a
a
a
a
a
a
a
a
a
a
s
d
d
d
A
J
d
d
P
P
d
"}
(39,1,1) = {"
a
a
a
a
a
a
a
a
a
a
a
a
a
a
a
a
a
a
a
a
a
a
a
a
a
a
a
a
a
a
a
a
a
a
a
a
a
a
Y
d
d
d
a
a
a
d
d
d
P
d
"}
(40,1,1) = {"
a
a
a
a
a
a
a
a
a
a
a
a
a
a
a
a
a
a
a
a
a
a
a
a
a
a
a
a
a
a
a
a
a
a
a
a
a
a
a
P
d
d
V
a
Y
d
d
d
d
d
"}
(41,1,1) = {"
a
a
a
a
a
a
a
a
a
a
a
a
a
a
a
a
a
a
a
a
a
a
a
a
a
a
a
a
a
a
a
a
a
a
a
a
a
a
a
P
P
D
a
a
a
o
d
X
d
d
"}
(42,1,1) = {"
a
a
a
a
a
a
a
a
a
a
a
a
a
a
a
a
a
a
a
a
a
a
a
a
a
a
a
a
a
a
a
a
a
a
a
a
a
a
a
a
a
a
a
a
a
Y
d
d
d
d
"}
(43,1,1) = {"
a
a
a
a
a
a
a
a
a
a
a
a
a
I
I
I
I
a
a
a
a
a
a
a
a
a
a
a
a
a
a
a
a
a
a
a
a
a
a
a
a
a
a
a
a
a
P
d
P
d
"}
(44,1,1) = {"
a
a
a
a
a
a
a
a
a
a
a
a
a
I
a
a
I
a
a
a
a
a
a
a
a
a
a
a
a
a
a
a
a
a
a
a
a
a
a
a
a
a
a
a
a
a
P
P
P
P
"}
(45,1,1) = {"
a
a
a
a
a
a
a
a
a
a
a
a
a
I
I
I
I
a
a
a
a
a
a
a
a
a
a
a
a
a
a
a
a
a
a
a
a
a
a
a
a
a
a
a
a
P
P
P
P
P
"}
(46,1,1) = {"
a
a
a
a
a
a
a
a
a
a
a
a
a
a
a
a
a
a
a
a
a
a
a
a
a
a
a
a
a
a
r
a
a
a
a
a
a
r
r
a
a
a
a
a
P
P
P
P
P
P
"}
(47,1,1) = {"
a
a
a
a
a
a
a
a
a
a
a
a
a
a
a
a
a
a
a
a
a
a
a
a
a
r
r
r
a
s
d
f
a
a
a
a
s
d
d
V
a
a
a
P
P
P
P
P
P
d
"}
(48,1,1) = {"
a
a
a
a
a
a
a
a
a
a
a
a
a
a
a
a
a
a
a
a
a
a
a
r
s
d
d
d
g
d
d
d
V
a
r
s
d
d
P
P
a
P
P
P
P
P
P
P
P
d
"}
(49,1,1) = {"
a
a
a
a
a
a
a
a
a
a
a
a
a
a
a
a
a
a
a
a
a
r
s
d
d
d
d
d
d
d
d
d
f
s
d
d
d
P
d
P
P
P
P
P
P
P
P
P
d
d
"}
(50,1,1) = {"
a
a
a
a
a
a
a
a
a
a
a
a
a
a
a
a
a
a
a
a
Y
d
d
d
d
d
X
d
d
d
d
d
d
d
d
d
d
d
d
d
P
P
P
P
P
P
P
P
d
d
"}
