//MAP CONVERTED BY dmm2tgm.py THIS HEADER COMMENT PREVENTS RECONVERSION, DO NOT REMOVE
"aC" = (
/obj/structure/stairs/stone{
	dir = 8
	},
/turf/open/misc/asteroid/snow/icemoon,
/area/ruin/unpowered/primitive_genemod_den)
"aG" = (
/obj/structure/bed/double/pelt,
/obj/structure/curtain/bounty,
/turf/open/floor/stone/icemoon,
/area/ruin/unpowered/primitive_genemod_den)
"bX" = (
/obj/effect/turf_decal/siding/wood/corner{
	dir = 1
	},
/obj/effect/turf_decal/siding/wood{
	dir = 1
	},
/turf/open/floor/wood/icemoon,
/area/ruin/unpowered/primitive_genemod_den)
"cy" = (
/obj/structure/rugs/pelt/black{
	dir = 4;
	pixel_y = -15
	},
/turf/open/floor/wood/icemoon,
/area/ruin/unpowered/primitive_genemod_den)
"cZ" = (
/obj/effect/turf_decal/weather/snow/corner{
	dir = 6
	},
/obj/effect/turf_decal/weather/snow/corner{
	dir = 9
	},
/obj/structure/flora/tree/pine/style_random,
/turf/open/misc/sandy_dirt/icemoon,
/area/ruin/unpowered/primitive_genemod_den)
"dF" = (
/obj/structure/table/wood,
/turf/open/floor/stone/icemoon,
/area/ruin/unpowered/primitive_genemod_den)
"dG" = (
/obj/effect/turf_decal/weather/snow/corner{
	dir = 6
	},
/obj/effect/turf_decal/weather/snow/corner,
/turf/open/misc/sandy_dirt/icemoon,
/area/ruin/unpowered/primitive_genemod_den)
"dM" = (
/obj/structure/rack/wooden,
/obj/item/bonesetter/primitive,
/obj/item/cautery/primitive,
/obj/item/chisel/primitive,
/obj/item/circular_saw/primitive,
/obj/item/scalpel/primitive,
/obj/item/retractor/primitive,
/obj/item/surgicaldrill/primitive,
/obj/structure/wall_torch/spawns_lit/directional/north,
/obj/item/smelling_salts,
/turf/open/floor/stone/icemoon,
/area/ruin/unpowered/primitive_genemod_den)
"ev" = (
/obj/effect/turf_decal/siding/wood{
	dir = 8
	},
/turf/open/floor/wood/icemoon,
/area/ruin/unpowered/primitive_genemod_den)
"ex" = (
/obj/structure/chair/wood,
/turf/open/floor/wood/icemoon,
/area/ruin/unpowered/primitive_genemod_den)
"eW" = (
/obj/structure/spacevine{
	name = "thick vines";
	opacity = 1
	},
/turf/closed/mineral/snowmountain/cavern/icemoon,
/area/ruin/unpowered/primitive_genemod_den)
"fl" = (
/obj/effect/turf_decal/siding/wood{
	dir = 4
	},
/turf/open/floor/wood/icemoon,
/area/ruin/unpowered/primitive_genemod_den)
"fs" = (
/obj/structure/wall_torch/spawns_lit/directional/south,
/turf/open/floor/wood/icemoon,
/area/ruin/unpowered/primitive_genemod_den)
"fF" = (
/obj/structure/rugs/pelt/black,
/obj/structure/chair/wood{
	dir = 1
	},
/turf/open/floor/wood/icemoon,
/area/ruin/unpowered/primitive_genemod_den)
"fW" = (
/obj/structure/rack/wooden,
/obj/item/reagent_containers/cup/glass/bottle/hooch{
	pixel_y = 8
	},
/obj/item/reagent_containers/cup/glass/bottle/moonshine{
	pixel_x = 8
	},
/obj/item/reagent_containers/cup/glass/bottle/moonshine{
	pixel_x = -6
	},
/turf/open/floor/stone/icemoon,
/area/ruin/unpowered/primitive_genemod_den)
"fX" = (
/turf/open/floor/wood/icemoon,
/area/ruin/unpowered/primitive_genemod_den)
"hq" = (
/obj/structure/wall_torch/spawns_lit/directional/north,
/turf/open/floor/wood/icemoon,
/area/ruin/unpowered/primitive_genemod_den)
"iM" = (
/obj/effect/turf_decal/weather/snow/corner,
/turf/closed/mineral/snowmountain/cavern/icemoon,
/area/ruin/unpowered/primitive_genemod_den)
"iT" = (
/obj/structure/wall_torch/spawns_lit/directional/west,
/turf/open/floor/wood/icemoon,
/area/ruin/unpowered/primitive_genemod_den)
"lq" = (
/obj/effect/turf_decal/weather/snow/corner{
	dir = 5
	},
/obj/effect/turf_decal/weather/snow/corner{
	dir = 10
	},
/turf/open/misc/sandy_dirt/icemoon,
/area/ruin/unpowered/primitive_genemod_den)
"lB" = (
/obj/structure/rack/wooden,
/obj/item/bonesetter/primitive,
/obj/item/cautery/primitive,
/obj/item/chisel/primitive,
/obj/item/circular_saw/primitive,
/obj/item/scalpel/primitive,
/obj/item/retractor/primitive,
/obj/item/surgicaldrill/primitive,
/obj/item/smelling_salts,
/turf/open/floor/stone/icemoon,
/area/ruin/unpowered/primitive_genemod_den)
"nX" = (
/obj/effect/turf_decal/weather/snow/corner{
	dir = 10
	},
/turf/open/misc/asteroid/snow/icemoon,
/area/ruin/unpowered/primitive_genemod_den)
"od" = (
/obj/effect/turf_decal/siding/wood/corner{
	dir = 4
	},
/turf/open/floor/wood/icemoon,
/area/ruin/unpowered/primitive_genemod_den)
"py" = (
/obj/effect/turf_decal/weather/snow/corner{
	dir = 6
	},
/turf/open/openspace/icemoon,
/area/ruin/unpowered/primitive_genemod_den)
"pP" = (
/obj/effect/turf_decal/weather/snow/corner{
	dir = 6
	},
/obj/effect/turf_decal/weather/snow/corner{
	dir = 9
	},
/turf/open/misc/sandy_dirt/icemoon,
/area/ruin/unpowered/primitive_genemod_den)
"sq" = (
/obj/structure/railing/wooden_fencing,
/turf/open/openspace/icemoon,
/area/ruin/unpowered/primitive_genemod_den)
"sr" = (
/obj/structure/rugs/pelt,
/turf/open/floor/wood/icemoon,
/area/ruin/unpowered/primitive_genemod_den)
"tb" = (
/obj/effect/turf_decal/weather/snow/corner{
	dir = 9
	},
/obj/effect/turf_decal/weather/snow/corner{
	dir = 4
	},
/turf/open/misc/sandy_dirt/icemoon,
/area/ruin/unpowered/primitive_genemod_den)
"tF" = (
/obj/structure/chair/wood{
	dir = 8
	},
/turf/open/floor/wood/icemoon,
/area/ruin/unpowered/primitive_genemod_den)
"uz" = (
/obj/structure/railing/wooden_fencing{
	dir = 8
	},
/turf/open/floor/wood/icemoon,
/area/ruin/unpowered/primitive_genemod_den)
"uG" = (
/obj/structure/table/wood,
/obj/structure/chem_separator{
	pixel_y = 12
	},
/turf/open/floor/stone/icemoon,
/area/ruin/unpowered/primitive_genemod_den)
"uT" = (
/obj/effect/turf_decal/weather/snow/corner{
	dir = 9
	},
/turf/open/openspace/icemoon,
/area/ruin/unpowered/primitive_genemod_den)
"vm" = (
/obj/structure/railing/wooden_fencing{
	dir = 1
	},
/obj/structure/chair/wood{
	dir = 4
	},
/obj/structure/wall_torch/spawns_lit/directional/west,
/turf/open/floor/wood/icemoon,
/area/ruin/unpowered/primitive_genemod_den)
"vZ" = (
/obj/structure/wall_torch/spawns_lit/directional/east,
/turf/open/openspace/icemoon,
/area/ruin/unpowered/primitive_genemod_den)
"yk" = (
/obj/structure/railing/wooden_fencing{
	dir = 8
	},
/obj/structure/railing/wooden_fencing,
/turf/open/openspace/icemoon,
/area/ruin/unpowered/primitive_genemod_den)
"zj" = (
/turf/open/misc/asteroid/snow/icemoon,
/area/ruin/unpowered/primitive_genemod_den)
"zu" = (
/obj/effect/turf_decal/weather/snow/corner{
	dir = 5
	},
/turf/open/misc/asteroid/snow/icemoon,
/area/ruin/unpowered/primitive_genemod_den)
"As" = (
/obj/effect/turf_decal/weather/snow/corner{
	dir = 8
	},
/turf/open/openspace/icemoon,
/area/ruin/unpowered/primitive_genemod_den)
"AZ" = (
/obj/effect/turf_decal/weather/snow/corner{
	dir = 6
	},
/turf/open/misc/asteroid/snow/icemoon,
/area/ruin/unpowered/primitive_genemod_den)
"By" = (
/obj/effect/turf_decal/weather/snow/corner{
	dir = 4
	},
/turf/open/openspace/icemoon,
/area/ruin/unpowered/primitive_genemod_den)
"CR" = (
/obj/structure/flora/tree/pine/style_random,
/turf/open/misc/asteroid/snow/icemoon,
/area/ruin/unpowered/primitive_genemod_den)
"El" = (
/obj/effect/turf_decal/weather/snow/corner{
	dir = 10
	},
/turf/open/openspace/icemoon,
/area/ruin/unpowered/primitive_genemod_den)
"EL" = (
/obj/effect/turf_decal/weather/snow/corner{
	dir = 5
	},
/turf/open/misc/sandy_dirt/icemoon,
/area/ruin/unpowered/primitive_genemod_den)
"EN" = (
/obj/effect/turf_decal/weather/snow/corner{
	dir = 5
	},
/obj/effect/turf_decal/weather/snow/corner{
	dir = 8
	},
/turf/open/misc/sandy_dirt/icemoon,
/area/ruin/unpowered/primitive_genemod_den)
"Fx" = (
/obj/effect/turf_decal/weather/snow/corner{
	dir = 10
	},
/obj/effect/turf_decal/weather/snow/corner{
	dir = 1
	},
/turf/open/misc/sandy_dirt/icemoon,
/area/ruin/unpowered/primitive_genemod_den)
"FV" = (
/obj/structure/railing/wooden_fencing{
	dir = 1
	},
/turf/open/openspace/icemoon,
/area/ruin/unpowered/primitive_genemod_den)
"Gd" = (
/turf/closed/mineral/snowmountain/cavern/icemoon,
/area/ruin/unpowered/primitive_genemod_den)
"GR" = (
/obj/structure/wall_torch/spawns_lit/directional/north,
/obj/effect/turf_decal/siding/wood{
	dir = 4
	},
/turf/open/floor/wood/icemoon,
/area/ruin/unpowered/primitive_genemod_den)
"HM" = (
/obj/item/pillow,
/turf/open/floor/wood/icemoon,
/area/ruin/unpowered/primitive_genemod_den)
"HP" = (
/obj/structure/railing/wooden_fencing{
	dir = 8
	},
/turf/open/openspace/icemoon,
/area/ruin/unpowered/primitive_genemod_den)
"Ih" = (
/turf/closed/wall/mineral/wood/nonmetal,
/area/ruin/unpowered/primitive_genemod_den)
"IE" = (
/obj/structure/railing/wooden_fencing{
	dir = 4
	},
/turf/open/floor/wood/icemoon,
/area/ruin/unpowered/primitive_genemod_den)
"Ku" = (
/obj/structure/table/wood,
/obj/structure/large_mortar,
/obj/item/pestle{
	pixel_y = -1;
	pixel_x = -8
	},
/turf/open/floor/stone/icemoon,
/area/ruin/unpowered/primitive_genemod_den)
"Lk" = (
/turf/open/misc/grass/roofing,
/area/ruin/unpowered/primitive_genemod_den)
"LO" = (
/obj/structure/railing/wooden_fencing{
	dir = 8
	},
/obj/structure/railing/wooden_fencing{
	dir = 1
	},
/turf/open/openspace/icemoon,
/area/ruin/unpowered/primitive_genemod_den)
"LP" = (
/obj/structure/table/wood,
/obj/item/reagent_containers/cup/primitive_centrifuge{
	pixel_x = -14;
	pixel_y = -1
	},
/obj/item/paper_bin/bundlenatural{
	pixel_y = 8;
	pixel_x = 3
	},
/obj/item/pen/charcoal,
/turf/open/floor/stone/icemoon,
/area/ruin/unpowered/primitive_genemod_den)
"LS" = (
/obj/effect/turf_decal/weather/snow/corner{
	dir = 6
	},
/turf/open/misc/sandy_dirt/icemoon,
/area/ruin/unpowered/primitive_genemod_den)
"MZ" = (
/obj/structure/railing/wooden_fencing{
	dir = 1
	},
/obj/structure/railing/wooden_fencing{
	dir = 8
	},
/turf/open/openspace/icemoon,
/area/ruin/unpowered/primitive_genemod_den)
"Nb" = (
/obj/effect/turf_decal/weather/snow/corner{
	dir = 1
	},
/turf/open/openspace/icemoon,
/area/ruin/unpowered/primitive_genemod_den)
"Nz" = (
/obj/effect/spawner/structure/window/ice,
/obj/structure/curtain/bounty,
/turf/open/floor/wood/icemoon,
/area/ruin/unpowered/primitive_genemod_den)
"OC" = (
/turf/open/floor/stone/icemoon,
/area/ruin/unpowered/primitive_genemod_den)
"Pr" = (
/obj/structure/wall_torch/spawns_lit/directional/south,
/obj/item/pillow,
/turf/open/floor/wood/icemoon,
/area/ruin/unpowered/primitive_genemod_den)
"Px" = (
/obj/structure/railing/wooden_fencing,
/obj/structure/railing/wooden_fencing{
	dir = 8
	},
/turf/open/openspace/icemoon,
/area/ruin/unpowered/primitive_genemod_den)
"Rj" = (
/obj/structure/spacevine{
	name = "thick vines";
	opacity = 1
	},
/turf/open/misc/asteroid/snow/icemoon,
/area/ruin/unpowered/primitive_genemod_den)
"Sy" = (
/obj/structure/railing/wooden_fencing{
	dir = 1
	},
/turf/open/floor/wood/icemoon,
/area/ruin/unpowered/primitive_genemod_den)
"TB" = (
/obj/effect/turf_decal/weather/snow/corner,
/turf/open/openspace/icemoon,
/area/ruin/unpowered/primitive_genemod_den)
"TO" = (
/obj/effect/turf_decal/weather/snow/corner{
	dir = 9
	},
/obj/effect/turf_decal/weather/snow/corner,
/turf/open/misc/sandy_dirt/icemoon,
/area/ruin/unpowered/primitive_genemod_den)
"UJ" = (
/obj/effect/turf_decal/weather/snow/corner{
	dir = 9
	},
/obj/effect/turf_decal/weather/snow/corner{
	dir = 6
	},
/turf/open/misc/sandy_dirt/icemoon,
/area/ruin/unpowered/primitive_genemod_den)
"UW" = (
/obj/effect/turf_decal/siding/wood{
	dir = 1
	},
/turf/open/floor/wood/icemoon,
/area/ruin/unpowered/primitive_genemod_den)
"Xc" = (
/obj/structure/stairs/stone,
/turf/open/misc/asteroid/snow/icemoon,
/area/ruin/unpowered/primitive_genemod_den)
"Xj" = (
/turf/open/openspace/icemoon,
/area/ruin/unpowered/primitive_genemod_den)
"XX" = (
/obj/effect/turf_decal/weather/snow/corner{
	dir = 10
	},
/obj/effect/turf_decal/weather/snow/corner{
	dir = 5
	},
/turf/open/misc/sandy_dirt/icemoon,
/area/ruin/unpowered/primitive_genemod_den)
"YK" = (
/obj/effect/turf_decal/weather/snow/corner{
	dir = 6
	},
/obj/effect/turf_decal/weather/snow/corner{
	dir = 8
	},
/obj/effect/turf_decal/weather/snow/corner{
	dir = 4
	},
/turf/open/misc/sandy_dirt/icemoon,
/area/ruin/unpowered/primitive_genemod_den)

(1,1,1) = {"
Xj
Gd
Gd
Xj
Xj
Xj
Gd
Gd
Gd
Gd
Gd
Gd
Gd
Gd
Gd
Gd
Gd
Gd
Gd
Gd
Gd
Gd
Gd
Gd
Gd
Gd
Gd
zj
zj
zj
zj
zj
zj
zj
zj
zj
zj
zj
zj
zj
Gd
Gd
Gd
Gd
zj
zj
Gd
Gd
zj
zj
"}
(2,1,1) = {"
Gd
Gd
Gd
Gd
Gd
Gd
Gd
Gd
Gd
Xj
Gd
Xj
TB
zj
zj
Gd
Gd
Gd
Gd
Gd
Gd
Gd
Gd
Gd
Gd
zj
zj
Gd
Gd
zj
zj
zj
zj
zj
zj
zj
zj
zj
zj
Gd
Gd
Gd
Gd
Gd
Gd
Gd
Gd
Gd
Gd
zj
"}
(3,1,1) = {"
Gd
Gd
Gd
Gd
Gd
Gd
Xj
Xj
Xj
Xj
Xj
Xj
Xj
El
zj
CR
zj
zj
Gd
Gd
Gd
Gd
Gd
Gd
Gd
zj
zj
eW
eW
Gd
zj
zj
zj
zj
cZ
zj
TO
zj
Gd
Gd
Gd
Gd
Gd
Gd
Gd
Gd
Gd
Gd
Gd
zj
"}
(4,1,1) = {"
Gd
Gd
Xj
Xj
Xj
Lk
Lk
Lk
Lk
Lk
Lk
Lk
Lk
Xj
El
zj
zj
zj
zj
Gd
Gd
Gd
Gd
Gd
zj
zj
zj
Rj
zj
zj
zj
zj
zj
zj
zj
tb
dG
zj
Gd
Gd
Gd
Gd
Gd
Gd
Gd
Gd
Gd
Gd
Gd
Gd
"}
(5,1,1) = {"
Gd
Gd
Xj
Xj
Lk
Lk
Lk
Lk
Lk
Lk
Lk
Lk
Lk
Lk
Xj
As
El
zj
zj
zj
zj
zj
Gd
Gd
Gd
Gd
eW
Rj
zj
zj
pP
zj
zj
pP
zj
zj
zj
pP
zj
Gd
Gd
Gd
Gd
Gd
Gd
Gd
Gd
Gd
Gd
Gd
"}
(6,1,1) = {"
Gd
Gd
Xj
Xj
Lk
Lk
Lk
Ih
Ih
Ih
Ih
Lk
Lk
Lk
Lk
Xj
Xj
El
zj
zj
zj
zj
zj
zj
Gd
Gd
Gd
Gd
pP
zj
zj
zj
zj
zj
zj
zj
zj
zj
zj
zj
Gd
Gd
Gd
Gd
Gd
Gd
Gd
Gd
Gd
Gd
"}
(7,1,1) = {"
Xj
Gd
Xj
Lk
Lk
Lk
Ih
Ih
IE
IE
Ih
Ih
Lk
Lk
Lk
Xj
Xj
Xj
As
As
As
El
zj
zj
zj
zj
zj
zj
zj
zj
zj
zj
uT
As
As
As
As
El
zj
zj
zj
zj
Gd
Gd
Gd
Gd
Gd
Gd
Gd
Gd
"}
(8,1,1) = {"
Xj
Xj
Xj
Lk
Lk
Ih
Ih
iT
Xj
Xj
vm
Ih
Ih
Lk
Lk
Lk
Xj
Xj
Xj
Xj
Xj
Xj
El
zj
zj
zj
pP
zj
zj
uT
As
As
Xj
Xj
Xj
Xj
Xj
Xj
El
zj
zj
zj
zj
Gd
Gd
Gd
Gd
Gd
Gd
Gd
"}
(9,1,1) = {"
Xj
Xj
Xj
Lk
Lk
Ih
fX
fX
Xj
Xj
Sy
fF
Ih
Lk
Lk
Lk
Lk
Lk
Xj
Xj
Xj
Xj
Xj
El
zj
zj
zj
zj
uT
Xj
Xj
Xj
Xj
Xj
Xj
Xj
Xj
Xj
Xj
El
zj
UJ
Xc
Gd
Gd
Gd
Gd
Gd
Gd
Gd
"}
(10,1,1) = {"
Xj
Xj
Xj
Lk
Lk
Ih
fX
fX
uz
uz
fX
fX
Ih
Lk
Lk
Lk
Lk
Lk
Xj
Xj
Xj
Xj
Xj
Xj
As
As
As
As
Xj
Xj
Xj
Xj
Xj
Xj
Xj
Xj
Xj
Xj
Xj
TB
zj
zj
Xc
Gd
Gd
Gd
Gd
Gd
Gd
zj
"}
(11,1,1) = {"
Xj
Xj
Xj
Lk
Lk
Ih
GR
fl
od
fX
fX
fs
Ih
Lk
Lk
Lk
Lk
Lk
Xj
Xj
Xj
Xj
Xj
Xj
Xj
Xj
Xj
Xj
Xj
Xj
Xj
Xj
Xj
Xj
Xj
Xj
Xj
Xj
Xj
TB
zj
zj
zj
Gd
Gd
Gd
Gd
Gd
Gd
zj
"}
(12,1,1) = {"
Xj
Xj
Xj
Lk
Lk
Ih
lB
OC
UW
fX
fX
fX
Ih
Lk
Lk
Lk
Lk
Lk
Xj
Xj
Xj
Xj
Xj
Xj
Xj
Xj
Xj
Xj
Xj
Xj
Xj
Xj
Xj
Xj
Xj
Xj
Xj
Xj
Xj
py
zj
zj
zj
zj
Gd
Gd
Gd
Gd
Gd
Gd
"}
(13,1,1) = {"
Xj
Xj
Xj
Lk
Lk
Ih
aG
OC
UW
fX
fX
fX
Nz
Lk
Lk
Lk
Lk
Lk
Xj
Xj
Xj
Xj
Xj
Xj
Xj
Xj
Xj
Xj
Xj
Xj
Xj
Xj
Xj
Xj
Xj
Xj
Xj
Xj
py
zj
zj
zj
zj
Gd
Gd
Gd
Gd
Gd
Gd
Gd
"}
(14,1,1) = {"
Xj
Xj
Xj
Lk
Lk
Ih
fW
OC
UW
fX
fX
fX
Nz
Lk
Lk
Lk
Lk
Lk
Xj
Xj
Xj
Xj
Xj
Xj
Xj
Xj
Xj
Xj
Xj
Xj
Xj
Xj
Xj
Xj
Xj
Xj
Xj
py
zj
zj
zj
zj
Gd
Gd
Gd
Gd
Gd
Gd
Gd
Gd
"}
(15,1,1) = {"
Xj
Xj
Xj
Lk
Lk
Ih
aG
OC
UW
fX
fX
fX
Ih
Lk
Lk
Lk
Lk
Lk
Xj
Xj
Lk
Lk
Lk
Lk
Lk
Lk
Lk
Lk
Lk
Xj
Xj
Xj
Xj
Xj
Xj
Xj
py
zj
zj
zj
zj
Gd
Gd
Gd
Gd
Gd
Gd
Gd
Gd
Gd
"}
(16,1,1) = {"
Xj
Xj
Xj
Lk
Lk
Ih
dM
OC
UW
fX
cy
Pr
Ih
Lk
Lk
Lk
Lk
Lk
Xj
Xj
Lk
Lk
Lk
Lk
Lk
Lk
Lk
Lk
Lk
Xj
Xj
Xj
Xj
Xj
Xj
py
zj
zj
zj
zj
Gd
Gd
Gd
Gd
Gd
Gd
Gd
Gd
Gd
Gd
"}
(17,1,1) = {"
Xj
Xj
Xj
Lk
Lk
Ih
Ku
OC
bX
fX
HM
fX
Ih
Lk
Lk
Lk
Lk
Lk
Xj
Xj
Lk
Lk
Lk
Lk
Lk
Lk
Lk
Lk
Lk
Xj
Xj
Xj
Xj
Xj
TB
zj
zj
zj
zj
Gd
Gd
Gd
Gd
Gd
Gd
Gd
Gd
Gd
Gd
Gd
"}
(18,1,1) = {"
Xj
Xj
Xj
Lk
Lk
Ih
LP
OC
UW
fX
fX
fX
Ih
Lk
Lk
Lk
Lk
Lk
Xj
Xj
Lk
Lk
Lk
Lk
Lk
Lk
Lk
Lk
Lk
Xj
Xj
Xj
Xj
Xj
TB
zj
zj
zj
zj
Gd
Gd
Gd
Gd
Xj
Xj
Gd
Gd
Gd
Gd
Gd
"}
(19,1,1) = {"
Xj
Xj
Xj
Lk
Lk
Ih
uG
OC
UW
fX
fX
fX
Nz
Lk
Lk
Lk
Xj
Xj
Xj
Xj
Lk
Lk
Lk
Lk
Lk
Lk
Lk
Lk
Lk
Xj
Xj
Xj
Xj
Xj
TB
zj
zj
zj
Gd
Gd
Gd
Gd
Xj
Xj
Xj
Gd
Gd
Gd
Gd
zj
"}
(20,1,1) = {"
Xj
Xj
Xj
Lk
Lk
Ih
dF
OC
UW
fX
fX
fX
Nz
Lk
Lk
Xj
Xj
Xj
Xj
Xj
Lk
Lk
Lk
Lk
Lk
Lk
Lk
Lk
Lk
Xj
Xj
Xj
Xj
Xj
TB
zj
zj
zj
Gd
Gd
Gd
Xj
Xj
Xj
Xj
Xj
Gd
Gd
Gd
zj
"}
(21,1,1) = {"
Xj
Xj
Xj
Lk
Lk
Ih
ev
ev
MZ
Px
fX
fX
Ih
Lk
Lk
Xj
Xj
Xj
Xj
Xj
Lk
Lk
Lk
Lk
Lk
Lk
Lk
Lk
Lk
Xj
Xj
Xj
Xj
Xj
Xj
El
zj
zj
Gd
Gd
Gd
Xj
Xj
Xj
Xj
Xj
Gd
Gd
zj
Gd
"}
(22,1,1) = {"
Xj
Xj
Xj
Lk
Lk
Ih
hq
fX
FV
sq
fX
fs
Ih
Lk
Lk
Xj
Xj
Xj
Xj
Xj
Lk
Lk
Lk
Lk
Lk
Lk
Lk
Lk
Lk
Xj
Xj
Xj
Xj
Xj
Xj
py
zj
zj
Gd
Gd
Gd
Xj
Xj
Xj
Xj
Xj
Gd
Gd
Gd
Gd
"}
(23,1,1) = {"
Xj
Xj
Xj
Lk
Lk
Ih
fX
fX
FV
sq
ex
sr
Ih
Lk
Lk
Xj
Xj
Xj
Xj
Xj
Lk
Lk
Lk
Lk
Lk
Lk
Lk
Lk
Lk
Xj
Xj
Xj
Xj
Xj
TB
zj
zj
zj
Gd
Gd
Gd
Xj
Xj
Xj
Xj
Xj
Gd
Gd
Gd
Gd
"}
(24,1,1) = {"
Xj
Xj
Xj
Lk
Lk
Ih
fX
fX
FV
sq
ex
fX
Ih
Lk
Lk
Xj
Xj
Xj
Xj
Xj
Lk
Lk
Lk
Lk
Lk
Lk
Lk
Lk
Lk
Xj
Xj
Xj
Xj
Xj
TB
zj
zj
zj
eW
Rj
zj
Nb
Xj
Xj
Xj
Xj
Gd
Gd
Gd
Gd
"}
(25,1,1) = {"
Xj
Xj
Xj
Lk
Lk
Ih
fX
LO
Xj
Xj
yk
tF
Ih
Lk
Lk
Xj
Xj
Xj
Xj
Xj
Xj
Xj
Xj
Xj
Xj
Xj
Xj
Xj
Xj
Xj
Xj
Xj
Xj
Xj
TB
zj
zj
zj
Rj
Rj
zj
Nb
Xj
Xj
Xj
Gd
Gd
Gd
Gd
Gd
"}
(26,1,1) = {"
Xj
Xj
Xj
Lk
Lk
Ih
HP
Xj
Xj
Xj
Xj
HP
Ih
Lk
Lk
Xj
Xj
Xj
Xj
Xj
Xj
Xj
Xj
Xj
Xj
Xj
Xj
Xj
Xj
Xj
Xj
Xj
Xj
Xj
TB
zj
zj
zj
zj
Rj
eW
Gd
Xj
Xj
Xj
Gd
Gd
Gd
Gd
Gd
"}
(27,1,1) = {"
Xj
Xj
Xj
Lk
Lk
Ih
Xj
Xj
Xj
Xj
Xj
Xj
Ih
Lk
Lk
Xj
Xj
Xj
Xj
Xj
Xj
Xj
Xj
Xj
Xj
Xj
Xj
Xj
Xj
Xj
Xj
Xj
Xj
Xj
Xj
El
zj
zj
zj
zj
eW
Gd
Gd
Gd
Gd
Gd
Gd
Gd
Gd
zj
"}
(28,1,1) = {"
Xj
Xj
Xj
Lk
Lk
Ih
Ih
vZ
Xj
Xj
vZ
Ih
Ih
Lk
Lk
Xj
Xj
Xj
Xj
Xj
Xj
Xj
Xj
Xj
Xj
Xj
Xj
Xj
Xj
Xj
Xj
Xj
Xj
Xj
Xj
Xj
El
zj
zj
zj
zj
Gd
Gd
Gd
Gd
Gd
Gd
Gd
zj
zj
"}
(29,1,1) = {"
Xj
Xj
Xj
Lk
Lk
Lk
Ih
Ih
Xj
Xj
Ih
Ih
Lk
Lk
Lk
Xj
Xj
Xj
Xj
Xj
Xj
Xj
Xj
Xj
Xj
Xj
Xj
Xj
Xj
Xj
Xj
Xj
Xj
Xj
Xj
Xj
Xj
El
zj
zj
zj
zj
zj
Gd
Gd
Gd
Gd
Gd
zj
zj
"}
(30,1,1) = {"
Xj
Xj
Xj
Xj
Lk
Lk
Lk
Ih
Ih
Ih
Ih
Lk
Lk
Lk
Xj
Xj
Xj
Xj
Xj
Xj
Xj
Xj
Xj
Xj
Xj
Xj
Xj
Xj
Xj
Xj
Xj
Xj
Xj
Xj
Xj
Xj
Xj
TB
zj
zj
zj
zj
zj
Gd
Gd
Gd
Gd
Gd
Gd
zj
"}
(31,1,1) = {"
Xj
Xj
Xj
Xj
Xj
Lk
Lk
Lk
Lk
Lk
Lk
Lk
Lk
Xj
Xj
Xj
Xj
Xj
Xj
Xj
Xj
Xj
Xj
Xj
Xj
Xj
Xj
Xj
Xj
Xj
Xj
Xj
Xj
Xj
Xj
Xj
Xj
Xj
El
zj
zj
zj
zj
zj
Gd
Gd
Gd
Gd
zj
zj
"}
(32,1,1) = {"
Xj
Xj
Xj
Xj
Xj
Xj
Xj
Xj
Xj
Xj
Xj
Xj
Xj
Xj
Xj
Xj
Xj
Xj
Xj
Xj
Xj
Xj
Xj
Xj
Xj
Xj
Xj
Xj
Xj
Xj
Xj
Xj
Xj
Xj
Xj
Xj
Xj
Xj
TB
zj
zj
CR
zj
zj
Gd
Gd
Gd
Gd
Gd
Gd
"}
(33,1,1) = {"
Xj
Xj
Xj
Xj
Xj
Xj
Xj
Xj
Xj
Xj
Xj
Xj
Xj
Xj
Xj
Xj
Xj
Xj
Xj
Xj
Xj
Xj
Xj
Xj
Xj
Xj
Xj
Xj
Xj
Xj
Xj
Xj
Xj
Xj
Xj
Xj
Xj
Xj
TB
zj
zj
zj
zj
zj
Gd
Gd
Gd
Gd
Gd
zj
"}
(34,1,1) = {"
Xj
Xj
Xj
Xj
Xj
Xj
Xj
Xj
Xj
Xj
Xj
Xj
Lk
Lk
Lk
Lk
Lk
Lk
Xj
Xj
Xj
Xj
Xj
Xj
Xj
Xj
Xj
Xj
Xj
Xj
Xj
Xj
Xj
Xj
Xj
Xj
Xj
Xj
TB
zj
zj
zj
zj
zj
Gd
Gd
Gd
Gd
Gd
zj
"}
(35,1,1) = {"
Xj
Xj
Xj
Xj
Xj
Xj
Xj
Xj
Xj
Xj
Xj
Lk
Lk
Lk
Lk
Lk
Lk
Lk
Lk
Lk
Xj
Xj
Xj
Xj
Xj
Xj
Xj
Xj
Xj
Xj
Xj
Xj
Xj
Xj
Xj
Xj
Xj
Xj
py
zj
zj
zj
zj
Gd
Gd
Gd
Gd
Gd
Gd
Gd
"}
(36,1,1) = {"
Xj
Xj
Xj
Xj
Xj
Xj
Xj
Xj
Xj
Xj
Lk
Lk
Lk
Lk
Lk
Lk
Lk
Lk
Lk
Lk
Lk
Lk
Lk
Lk
Lk
Xj
Xj
Xj
Xj
Xj
Xj
Xj
Xj
Xj
Xj
Xj
Xj
TB
zj
zj
zj
zj
Gd
Gd
Gd
Gd
Gd
Gd
Gd
Gd
"}
(37,1,1) = {"
Xj
Xj
Xj
Xj
Xj
Lk
Lk
Lk
Lk
Lk
Lk
Lk
Lk
Lk
Lk
Lk
Lk
Lk
Lk
Lk
Lk
Lk
Lk
Lk
Lk
Lk
Xj
Xj
Xj
Xj
Xj
Xj
Xj
Xj
Xj
Xj
Xj
py
zj
zj
zj
Gd
Gd
Gd
Gd
Gd
Gd
Gd
Gd
Gd
"}
(38,1,1) = {"
Xj
Xj
Xj
Xj
Xj
Lk
Lk
Lk
Lk
Lk
Lk
Lk
Lk
Lk
Lk
Lk
Lk
Lk
Lk
Lk
Lk
Lk
Lk
Lk
Lk
Lk
Xj
Xj
Xj
Xj
Xj
Xj
Xj
Xj
Xj
Xj
TB
zj
zj
zj
Gd
Gd
Gd
Gd
Gd
Gd
Gd
Gd
Gd
zj
"}
(39,1,1) = {"
Xj
Xj
Xj
Xj
Xj
Lk
Lk
Lk
Lk
Lk
Lk
Lk
Lk
Lk
Lk
Lk
Lk
Lk
Lk
Lk
Lk
Lk
Lk
Lk
Lk
Lk
Xj
Xj
Xj
Xj
Xj
Xj
Xj
Xj
Xj
Xj
TB
zj
zj
Gd
Gd
Gd
aC
aC
aC
Gd
Gd
Gd
Gd
zj
"}
(40,1,1) = {"
Xj
Xj
Xj
Xj
Xj
Lk
Lk
Lk
Lk
Lk
Lk
Lk
Lk
Lk
Lk
Lk
Lk
Lk
Lk
Lk
Lk
Lk
Lk
Lk
Lk
Lk
Xj
Xj
Xj
Xj
Xj
Xj
Xj
Xj
Xj
Xj
TB
zj
zj
Gd
Gd
Gd
zu
EL
LS
zj
Gd
Gd
Gd
zj
"}
(41,1,1) = {"
Xj
Xj
Xj
Xj
Xj
Lk
Lk
Lk
Lk
Lk
Lk
Lk
Lk
Lk
Lk
Lk
Lk
Lk
Lk
Lk
Lk
Lk
Lk
Lk
Lk
Lk
Xj
Xj
Xj
Xj
Xj
Xj
Xj
Xj
Xj
Xj
py
zj
Gd
Gd
Gd
zj
zu
zu
AZ
zj
zj
Gd
Gd
zj
"}
(42,1,1) = {"
Xj
Xj
Xj
Xj
Xj
Lk
Lk
Lk
Lk
Lk
Lk
Lk
Lk
Lk
Lk
Lk
Lk
Lk
Lk
Lk
Lk
Lk
Lk
Lk
Lk
Lk
Xj
Xj
Xj
Xj
Xj
Xj
Xj
Xj
Xj
py
zj
zj
Gd
Gd
zj
zj
Fx
zu
lq
zj
zj
Gd
Gd
zj
"}
(43,1,1) = {"
Xj
Xj
Xj
Xj
Xj
Lk
Lk
Lk
Lk
Lk
Lk
Lk
Lk
Ih
Ih
Ih
Ih
Lk
Lk
Lk
Lk
Lk
Lk
Lk
Lk
Lk
Xj
Xj
Xj
Xj
Xj
Xj
By
By
py
zj
zj
zj
zj
zj
nX
EN
LS
zj
zj
zj
zj
Gd
Gd
zj
"}
(44,1,1) = {"
Xj
Xj
Xj
Xj
Xj
Lk
Lk
Lk
Lk
Lk
Lk
Lk
Lk
Ih
Xj
Xj
Ih
Lk
Lk
Lk
Lk
Lk
Lk
Lk
Lk
Lk
Xj
Xj
Xj
Xj
Xj
TB
zj
zj
zj
zj
zj
zj
zj
zj
XX
zj
zj
zj
zj
zj
zj
Gd
Gd
Gd
"}
(45,1,1) = {"
Xj
Xj
Xj
Xj
Xj
Lk
Lk
Lk
Lk
Lk
Lk
Lk
Lk
Ih
Ih
Ih
Ih
Lk
Lk
Lk
Lk
Lk
Lk
Lk
Lk
Lk
Xj
Xj
Xj
Xj
Xj
py
zj
tb
YK
zj
zj
zj
lq
zj
zj
zj
zj
zj
zj
zj
zj
Gd
Gd
Gd
"}
(46,1,1) = {"
Xj
Xj
Xj
Xj
Xj
Xj
Xj
Xj
Xj
Xj
Lk
Lk
Lk
Lk
Lk
Lk
Lk
Lk
Lk
Xj
Xj
Xj
Xj
Xj
Xj
Xj
Xj
Xj
Xj
Xj
TB
zj
zj
zj
zj
pP
zj
zj
zj
zj
zj
zj
zj
zj
zj
zj
Gd
Gd
Gd
Gd
"}
(47,1,1) = {"
Xj
Xj
Xj
Xj
Xj
Xj
Xj
Xj
Xj
Xj
Xj
Xj
Xj
Xj
Xj
Xj
Xj
Xj
Xj
Xj
Xj
Xj
Xj
Xj
Xj
Xj
Xj
Xj
Xj
Xj
iM
Gd
Gd
zj
zj
zj
zj
zj
zj
zj
zj
zj
zj
Gd
Gd
Gd
Gd
Gd
Gd
Gd
"}
(48,1,1) = {"
Xj
Xj
Xj
Xj
Xj
Xj
Xj
Xj
Xj
Xj
Xj
Xj
Xj
Xj
Xj
Xj
Xj
Xj
Xj
Xj
Xj
Xj
Xj
Xj
Xj
Xj
Xj
Xj
Xj
Gd
Gd
Gd
zj
zj
zj
zj
Gd
Gd
Gd
Gd
Gd
Gd
Gd
Gd
Gd
Gd
Gd
Gd
Gd
zj
"}
(49,1,1) = {"
Xj
Xj
Xj
Xj
Xj
Xj
Xj
Xj
Xj
Xj
Xj
Xj
Xj
Xj
Xj
Xj
Xj
Xj
Xj
Xj
Xj
Xj
Xj
Xj
Xj
Gd
Gd
Gd
Gd
Gd
zj
zj
zj
zj
zj
zj
Gd
Gd
Gd
Gd
Gd
Gd
Gd
Gd
Gd
Gd
Gd
Gd
Gd
Gd
"}
(50,1,1) = {"
Xj
Xj
Xj
Xj
Xj
Xj
Xj
Xj
Xj
Xj
Xj
Xj
Xj
Xj
Xj
Xj
Xj
Xj
Xj
Xj
Xj
Xj
Gd
Gd
Gd
Gd
Gd
Gd
Gd
zj
zj
zj
zj
zj
zj
zj
zj
zj
zj
Gd
Gd
Gd
Gd
Gd
Gd
Gd
zj
zj
zj
zj
"}
