//MAP CONVERTED BY dmm2tgm.py THIS HEADER COMMENT PREVENTS RECONVERSION, DO NOT REMOVE
"ak" = (
/obj/effect/decal/cleanable/dirt,
/turf/open/floor/plating/aluminum,
/area/station/salvage_bay)
"aO" = (
/obj/machinery/door/firedoor,
/obj/machinery/door/poddoor/shutters{
	id = "shipbreaking";
	name = "Salvage Bay Shutters"
	},
/obj/machinery/button/door/directional/north{
	id = "shipbreaking"
	},
/obj/machinery/atmospherics/pipe/smart/manifold4w/supply/hidden/layer4,
/obj/machinery/atmospherics/pipe/smart/manifold4w/scrubbers/hidden/layer2,
/turf/open/floor/iron/dark/textured_large,
/area/station/salvage_bay)
"aQ" = (
/obj/machinery/computer/mech_bay_power_console{
	dir = 4
	},
/turf/open/floor/plating,
/area/station/salvage_bay)
"bI" = (
/obj/structure/sign/semiotic/vacuum_ahead/directional/north,
/turf/open/floor/plating/aluminum,
/area/station/salvage_bay)
"cg" = (
/obj/structure/chair/plastic{
	dir = 4
	},
/turf/open/floor/iron/dark/textured_large,
/area/station/salvage_bay)
"cz" = (
/obj/effect/decal/cleanable/dirt/dust,
/obj/structure/marker_beacon/yellow,
/turf/open/floor/plating/reinforced/airless,
/area/space/nearstation)
"cJ" = (
/obj/machinery/atmospherics/components/unary/vent_scrubber/on/layer2,
/obj/effect/decal/cleanable/dirt,
/turf/open/floor/plating,
/area/station/salvage_bay)
"dS" = (
/obj/structure/sign/semiotic/warning,
/turf/closed/wall/r_wall,
/area/station/salvage_bay)
"eb" = (
/obj/structure/railing{
	dir = 1
	},
/turf/open/floor/iron/stairs/right{
	dir = 4
	},
/area/station/salvage_bay)
"ez" = (
/obj/machinery/recycler{
	dir = 1
	},
/obj/machinery/conveyor{
	id = "SalvageProcess"
	},
/turf/open/floor/plating,
/area/station/salvage_bay)
"eZ" = (
/obj/machinery/atmospherics/pipe/smart/manifold4w/supply/hidden/layer4,
/obj/machinery/atmospherics/pipe/smart/manifold4w/scrubbers/hidden/layer2,
/obj/effect/decal/cleanable/dirt,
/turf/open/floor/iron/grimy,
/area/station/salvage_bay)
"ff" = (
/obj/structure/table,
/turf/open/floor/iron/dark/textured_large,
/area/station/salvage_bay)
"fn" = (
/turf/open/floor/iron/smooth,
/area/station/salvage_bay)
"fF" = (
/obj/machinery/conveyor{
	dir = 4;
	id = "SalvageProcess"
	},
/obj/machinery/camera/autoname/directional/north,
/turf/open/floor/plating,
/area/station/salvage_bay)
"fV" = (
/obj/structure/railing{
	dir = 4
	},
/obj/machinery/atmospherics/components/unary/vent_pump/on/layer4{
	dir = 8
	},
/obj/machinery/light_switch/directional/north,
/turf/open/floor/iron/smooth,
/area/station/salvage_bay)
"fX" = (
/obj/structure/railing{
	dir = 1
	},
/obj/structure/table,
/obj/item/storage/cans/sixbeer,
/turf/open/floor/iron/dark/textured_large,
/area/station/salvage_bay)
"gh" = (
/obj/machinery/atmospherics/pipe/smart/manifold4w/supply/hidden/layer4,
/obj/machinery/atmospherics/pipe/smart/manifold4w/scrubbers/hidden/layer2,
/obj/machinery/camera/autoname/directional/south,
/turf/open/floor/iron/stairs/right{
	dir = 8
	},
/area/station/salvage_bay)
"gz" = (
/obj/structure/cable,
/turf/open/floor/plating,
/area/station/maintenance/fore/greater)
"gM" = (
/obj/machinery/atmospherics/components/unary/vent_scrubber/on/layer2{
	dir = 1
	},
/obj/machinery/light/red/dim/directional/south,
/turf/open/floor/plating,
/area/station/salvage_bay)
"gW" = (
/obj/machinery/atmospherics/pipe/smart/manifold4w/supply/hidden/layer4,
/obj/machinery/atmospherics/pipe/smart/manifold4w/scrubbers/hidden/layer2,
/obj/machinery/light/dim/directional/west,
/obj/machinery/firealarm/directional/west,
/obj/effect/decal/cleanable/dirt,
/turf/open/floor/catwalk_floor/iron_smooth,
/area/station/salvage_bay)
"ic" = (
/obj/machinery/conveyor{
	dir = 4;
	id = "SalvageProcess"
	},
/obj/machinery/door/firedoor,
/obj/structure/plasticflaps,
/turf/open/floor/plating,
/area/station/salvage_bay)
"ig" = (
/obj/structure/railing{
	dir = 4
	},
/turf/open/floor/plating,
/area/station/salvage_bay)
"iy" = (
/obj/structure/shuttle_decoration/headlight/directional/east,
/obj/structure/shuttle_decoration/headlight/directional/north,
/turf/closed/wall,
/area/station/salvage_bay)
"jf" = (
/obj/structure/table/reinforced,
/obj/item/radio,
/turf/open/floor/iron/dark/textured_large,
/area/station/salvage_bay)
"jA" = (
/obj/machinery/conveyor{
	id = "SalvageProcess"
	},
/obj/machinery/camera/autoname/directional/west,
/turf/open/floor/plating,
/area/station/salvage_bay)
"kk" = (
/obj/effect/decal/cleanable/dirt,
/turf/open/floor/catwalk_floor,
/area/station/salvage_bay)
"ku" = (
/obj/machinery/atmospherics/pipe/smart/manifold4w/supply/hidden/layer4,
/obj/machinery/atmospherics/pipe/smart/manifold4w/scrubbers/hidden/layer2,
/obj/machinery/light/dim/directional/west,
/turf/open/floor/catwalk_floor/iron_smooth,
/area/station/salvage_bay)
"kA" = (
/obj/effect/spawner/random/engineering/canister,
/turf/open/floor/iron/dark/textured_large,
/area/station/salvage_bay)
"lg" = (
/obj/structure/cable,
/turf/open/floor/catwalk_floor/iron_smooth,
/area/station/salvage_bay)
"lu" = (
/obj/structure/lattice/catwalk,
/turf/open/space/openspace,
/area/space/nearstation)
"lx" = (
/obj/effect/mapping_helpers/broken_floor,
/obj/machinery/light/small/red/dim/directional/east,
/obj/structure/sign/warning/electric_shock/directional/east,
/obj/structure/cable,
/turf/open/floor/plating,
/area/station/maintenance/fore/greater)
"me" = (
/obj/machinery/modular_computer/preset/engineering{
	dir = 8
	},
/turf/open/floor/iron/dark/textured_large,
/area/station/salvage_bay)
"mt" = (
/obj/effect/spawner/random/salvage/container_or_crate_or_cargo/salvage,
/obj/effect/decal/cleanable/dirt,
/turf/open/floor/plating/aluminum,
/area/station/salvage_bay)
"nN" = (
/obj/effect/decal/cleanable/dirt,
/turf/open/floor/plating,
/area/station/salvage_bay)
"nP" = (
/obj/structure/railing{
	dir = 1
	},
/turf/open/floor/iron/stairs/left{
	dir = 8
	},
/area/station/salvage_bay)
"ov" = (
/turf/open/space/openspace,
/area/space)
"pi" = (
/obj/effect/spawner/structure/window/reinforced,
/turf/open/floor/plating,
/area/station/salvage_bay)
"pw" = (
/obj/structure/lattice,
/turf/open/space/openspace,
/area/space/nearstation)
"px" = (
/turf/template_noop,
/area/template_noop)
"pA" = (
/obj/effect/spawner/random/salvage/container_or_crate_or_cargo/salvage,
/turf/open/floor/plating/aluminum,
/area/station/salvage_bay)
"pC" = (
/obj/structure/railing{
	dir = 8
	},
/obj/machinery/mineral/stacking_machine,
/turf/open/floor/iron/dark/textured_large,
/area/station/salvage_bay)
"qv" = (
/obj/structure/sign/semiotic/storage,
/turf/closed/wall/r_wall,
/area/station/salvage_bay)
"ra" = (
/obj/machinery/atmospherics/components/unary/vent_pump/on/layer4{
	dir = 1
	},
/obj/structure/cable,
/turf/open/floor/iron/smooth,
/area/station/salvage_bay)
"rn" = (
/obj/machinery/atmospherics/components/unary/vent_scrubber/on/layer2,
/obj/effect/decal/cleanable/dirt,
/turf/open/floor/iron/smooth,
/area/station/salvage_bay)
"ro" = (
/obj/structure/lattice/catwalk,
/obj/structure/railing{
	dir = 4
	},
/turf/open/space/openspace,
/area/space/nearstation)
"sD" = (
/obj/machinery/atmospherics/pipe/smart/manifold4w/supply/hidden/layer4,
/obj/machinery/atmospherics/pipe/smart/manifold4w/scrubbers/hidden/layer2,
/turf/open/floor/iron/smooth,
/area/station/salvage_bay)
"ti" = (
/obj/machinery/computer/salvage_bay_controller{
	dir = 8
	},
/turf/open/floor/iron/dark/textured_large,
/area/station/salvage_bay)
"tw" = (
/obj/structure/sign/semiotic/airlock/directional/east,
/obj/machinery/atmospherics/components/unary/vent_pump/on/layer4,
/obj/effect/decal/cleanable/dirt,
/turf/open/floor/iron/smooth,
/area/station/salvage_bay)
"tD" = (
/obj/machinery/light/dim/directional/north,
/obj/structure/sign/poster/random/directional/north,
/turf/open/floor/plating/aluminum,
/area/station/salvage_bay)
"tT" = (
/obj/item/radio/intercom/directional/north,
/obj/machinery/newscaster/directional/west,
/obj/machinery/atmospherics/components/unary/vent_scrubber/on/layer2{
	dir = 4
	},
/obj/machinery/camera/autoname/directional/north,
/turf/open/floor/iron/grimy,
/area/station/salvage_bay)
"tY" = (
/turf/closed/wall,
/area/station/salvage_bay)
"un" = (
/obj/effect/decal/cleanable/dirt/dust,
/turf/open/floor/plating/reinforced/airless,
/area/space/nearstation)
"vk" = (
/obj/machinery/atmospherics/pipe/smart/manifold4w/supply/hidden/layer4,
/obj/effect/turf_decal/siding/thinplating_new/dark{
	dir = 5
	},
/obj/effect/turf_decal/trimline/brown/corner{
	dir = 8
	},
/obj/machinery/atmospherics/pipe/smart/manifold4w/scrubbers/hidden/layer2,
/turf/open/floor/iron/dark/smooth_corner{
	dir = 8
	},
/area/station/cargo/warehouse)
"vq" = (
/obj/machinery/conveyor{
	id = "SalvageProcess"
	},
/turf/open/floor/plating,
/area/station/salvage_bay)
"wC" = (
/obj/machinery/atmos_shield_gen/active{
	dir = 8
	},
/obj/machinery/conveyor{
	id = "SalvageProcess"
	},
/turf/open/floor/plating,
/area/station/salvage_bay)
"wR" = (
/turf/open/floor/plating,
/area/station/salvage_bay)
"wU" = (
/obj/machinery/mech_bay_recharge_port{
	dir = 1
	},
/turf/open/floor/plating,
/area/station/salvage_bay)
"xa" = (
/obj/structure/railing{
	dir = 1
	},
/obj/machinery/atmospherics/pipe/smart/manifold4w/supply/hidden/layer4,
/obj/machinery/atmospherics/pipe/smart/manifold4w/scrubbers/hidden/layer2,
/turf/open/floor/catwalk_floor/iron_smooth,
/area/station/salvage_bay)
"xM" = (
/obj/structure/sign/semiotic/vacuum_ahead/directional/east,
/turf/open/floor/plating,
/area/station/salvage_bay)
"yF" = (
/obj/structure/railing{
	dir = 4
	},
/obj/machinery/atmospherics/components/unary/vent_scrubber/on/layer2{
	dir = 8
	},
/turf/open/floor/iron/smooth,
/area/station/salvage_bay)
"yI" = (
/obj/machinery/atmospherics/pipe/smart/manifold4w/supply/hidden/layer4,
/obj/machinery/atmospherics/pipe/smart/manifold4w/scrubbers/hidden/layer2,
/turf/open/floor/iron/stairs/left{
	dir = 4
	},
/area/station/salvage_bay)
"yN" = (
/obj/machinery/docking_clamp{
	dir = 1
	},
/obj/effect/decal/cleanable/dirt/dust,
/turf/open/floor/plating/reinforced/airless,
/area/space/nearstation)
"za" = (
/obj/machinery/atmospherics/components/unary/vent_scrubber/on/layer2{
	dir = 8
	},
/turf/open/floor/iron/smooth,
/area/station/salvage_bay)
"zm" = (
/obj/structure/tank_dispenser/oxygen,
/turf/open/floor/iron/dark/textured_large,
/area/station/salvage_bay)
"Af" = (
/obj/structure/cable,
/obj/machinery/power/apc/auto_name/directional/north,
/turf/open/floor/catwalk_floor/iron_smooth,
/area/station/salvage_bay)
"Ao" = (
/obj/machinery/airalarm/directional/north,
/obj/machinery/camera/autoname/directional/north,
/turf/open/floor/iron/smooth,
/area/station/salvage_bay)
"As" = (
/obj/structure/lattice/catwalk,
/obj/structure/marker_beacon/yellow,
/turf/open/space/openspace,
/area/space/nearstation)
"Cm" = (
/obj/structure/closet/secure_closet/engineering_electrical,
/turf/open/floor/iron/dark/textured_large,
/area/station/salvage_bay)
"Df" = (
/obj/machinery/conveyor{
	id = "SalvageProcess"
	},
/obj/machinery/light/dim/directional/east,
/turf/open/floor/plating,
/area/station/salvage_bay)
"DP" = (
/obj/machinery/light/dim/directional/south,
/obj/machinery/newscaster/directional/south,
/obj/effect/decal/cleanable/dirt,
/turf/open/floor/iron/smooth,
/area/station/salvage_bay)
"Ez" = (
/obj/structure/railing{
	dir = 8
	},
/obj/structure/sign/semiotic/vacuum_ahead/directional/north,
/turf/open/floor/iron/dark/textured_large,
/area/station/salvage_bay)
"FC" = (
/obj/machinery/door/firedoor,
/obj/machinery/door/poddoor/shutters{
	id = "shipbreaking";
	name = "Salvage Bay Shutters"
	},
/turf/open/floor/iron/dark/textured_large,
/area/station/salvage_bay)
"Ge" = (
/obj/machinery/mineral/stacking_unit_console{
	pixel_y = 32
	},
/obj/machinery/airalarm/directional/east,
/obj/effect/decal/cleanable/dirt,
/turf/open/floor/iron/dark/textured_large,
/area/station/salvage_bay)
"GV" = (
/obj/machinery/light/small/blacklight/directional/west,
/obj/machinery/conveyor{
	dir = 4;
	id = "SalvageProcess"
	},
/obj/machinery/camera/autoname/directional/south,
/turf/open/floor/plating,
/area/station/salvage_bay)
"Hi" = (
/obj/vehicle/sealed/mecha/ripley/cargo,
/obj/effect/turf_decal/recharge,
/turf/open/floor/plating,
/area/station/salvage_bay)
"HV" = (
/obj/machinery/atmospherics/components/unary/vent_pump/on/layer4,
/obj/effect/decal/cleanable/dirt,
/turf/open/floor/plating,
/area/station/salvage_bay)
"ID" = (
/obj/structure/railing{
	dir = 1
	},
/obj/machinery/conveyor_switch/oneway{
	id = "SalvageProcess";
	name = "Salvage Processor";
	pixel_x = -8;
	pixel_y = 1
	},
/turf/open/floor/plating,
/area/station/salvage_bay)
"Jg" = (
/obj/structure/chair/office{
	dir = 4
	},
/obj/machinery/atmospherics/pipe/smart/manifold4w/scrubbers/hidden/layer2,
/turf/open/floor/iron/grimy,
/area/station/salvage_bay)
"JB" = (
/obj/machinery/atmospherics/pipe/smart/manifold4w/supply/hidden/layer4,
/obj/effect/turf_decal/siding/thinplating_new/dark{
	dir = 1
	},
/obj/effect/turf_decal/trimline/brown/warning,
/obj/effect/turf_decal/trimline/brown/mid_joiner,
/obj/machinery/atmospherics/pipe/smart/manifold4w/scrubbers/hidden/layer2,
/turf/open/floor/iron/dark/smooth_half,
/area/station/cargo/warehouse)
"JS" = (
/obj/structure/railing{
	dir = 1
	},
/obj/structure/chair/plastic{
	dir = 8
	},
/turf/open/floor/iron/dark/textured_large,
/area/station/salvage_bay)
"KE" = (
/obj/machinery/atmospherics/pipe/smart/manifold4w/supply/hidden/layer4,
/obj/machinery/atmospherics/pipe/smart/manifold4w/scrubbers/hidden/layer2,
/obj/effect/decal/cleanable/dirt,
/turf/open/floor/catwalk_floor,
/area/station/salvage_bay)
"KP" = (
/obj/machinery/door/airlock/external,
/obj/effect/mapping_helpers/airlock/cyclelink_helper{
	dir = 4
	},
/obj/effect/mapping_helpers/airlock/access/all/engineering/maintenance,
/obj/machinery/atmospherics/pipe/smart/manifold4w/supply/hidden/layer4,
/obj/machinery/atmospherics/pipe/smart/manifold4w/scrubbers/hidden/layer2,
/turf/open/floor/iron/dark/textured_large,
/area/station/salvage_bay)
"Lm" = (
/obj/machinery/suit_storage_unit/engine,
/obj/effect/decal/cleanable/dirt,
/turf/open/floor/iron/dark/textured_large,
/area/station/salvage_bay)
"LV" = (
/obj/structure/sign/poster/random/directional/south,
/obj/effect/decal/cleanable/dirt,
/turf/open/floor/iron/smooth,
/area/station/salvage_bay)
"Mt" = (
/obj/machinery/door/airlock/external,
/obj/effect/mapping_helpers/airlock/cyclelink_helper{
	dir = 8
	},
/obj/effect/mapping_helpers/airlock/access/all/engineering/maintenance,
/turf/open/floor/iron/dark/textured_large,
/area/station/salvage_bay)
"My" = (
/obj/machinery/door/airlock/grunge{
	name = "Salvage Oversight"
	},
/obj/effect/mapping_helpers/airlock/access/all/engineering/maintenance,
/obj/machinery/atmospherics/pipe/smart/manifold4w/supply/hidden/layer4,
/obj/machinery/atmospherics/pipe/smart/manifold4w/scrubbers/hidden/layer2,
/turf/open/floor/iron/dark/textured_large,
/area/station/salvage_bay)
"MS" = (
/obj/structure/railing{
	dir = 4
	},
/obj/machinery/firealarm/directional/south,
/obj/effect/decal/cleanable/dirt,
/turf/open/floor/iron/smooth,
/area/station/salvage_bay)
"Nd" = (
/turf/open/floor/plating/aluminum,
/area/station/salvage_bay)
"Nt" = (
/obj/machinery/conveyor{
	id = "SalvageProcess"
	},
/obj/machinery/door/firedoor,
/obj/structure/plasticflaps,
/turf/open/floor/plating,
/area/station/salvage_bay)
"NJ" = (
/obj/machinery/light/dim/directional/east,
/obj/machinery/firealarm/directional/east,
/obj/effect/decal/cleanable/dirt,
/turf/open/floor/iron/dark/textured_large,
/area/station/salvage_bay)
"OW" = (
/obj/structure/table/reinforced,
/obj/item/paper_bin/carbon,
/obj/item/pen/fourcolor,
/turf/open/floor/iron/dark/textured_large,
/area/station/salvage_bay)
"Pb" = (
/obj/machinery/atmospherics/pipe/smart/manifold4w/supply/hidden/layer4,
/obj/machinery/atmospherics/pipe/smart/manifold4w/scrubbers/hidden/layer2,
/obj/machinery/holopad,
/obj/effect/decal/cleanable/dirt,
/turf/open/floor/iron/grimy,
/area/station/salvage_bay)
"PJ" = (
/obj/machinery/atmospherics/pipe/smart/manifold4w/supply/hidden/layer4,
/obj/machinery/atmospherics/pipe/smart/manifold4w/scrubbers/hidden/layer2,
/turf/open/floor/catwalk_floor/iron_smooth,
/area/station/salvage_bay)
"PL" = (
/obj/machinery/atmospherics/pipe/smart/manifold4w/supply/hidden/layer4,
/obj/machinery/atmospherics/pipe/smart/manifold4w/scrubbers/hidden/layer2,
/obj/effect/decal/cleanable/dirt,
/turf/open/floor/plating,
/area/station/salvage_bay)
"PQ" = (
/obj/machinery/conveyor{
	dir = 4;
	id = "SalvageProcess"
	},
/turf/open/floor/plating,
/area/station/salvage_bay)
"PU" = (
/obj/structure/railing{
	dir = 1
	},
/obj/structure/chair/plastic{
	dir = 4
	},
/turf/open/floor/iron/dark/textured_large,
/area/station/salvage_bay)
"Rh" = (
/turf/open/floor/iron/dark/textured_large,
/area/station/salvage_bay)
"SB" = (
/obj/machinery/atmospherics/components/unary/vent_pump/on/layer4{
	dir = 4
	},
/obj/effect/decal/cleanable/dirt,
/turf/open/floor/iron/grimy,
/area/station/salvage_bay)
"SM" = (
/obj/machinery/atmospherics/pipe/smart/manifold4w/supply/hidden/layer4,
/obj/machinery/atmospherics/pipe/smart/manifold4w/scrubbers/hidden/layer2,
/obj/structure/cable,
/turf/open/floor/catwalk_floor/iron_smooth,
/area/station/salvage_bay)
"Tp" = (
/obj/structure/railing{
	dir = 5
	},
/obj/structure/tank_holder/extinguisher/advanced,
/turf/open/floor/plating,
/area/station/salvage_bay)
"TX" = (
/obj/machinery/door/airlock/atmos{
	name = "Salvage Bay"
	},
/obj/machinery/door/firedoor,
/obj/effect/mapping_helpers/airlock/access/all/engineering/maintenance,
/obj/structure/cable,
/turf/open/floor/iron/dark/textured_large,
/area/station/salvage_bay)
"Uw" = (
/obj/structure/shelf,
/obj/item/clothing/glasses/meson{
	pixel_y = -8
	},
/obj/item/binoculars{
	pixel_y = 13
	},
/obj/machinery/firealarm/directional/west,
/turf/open/floor/iron/dark/textured_large,
/area/station/salvage_bay)
"Uz" = (
/turf/closed/wall/r_wall,
/area/station/salvage_bay)
"UM" = (
/obj/effect/turf_decal/loading_area/white,
/obj/effect/decal/cleanable/dirt/dust,
/turf/open/floor/plating/reinforced/airless,
/area/space/nearstation)
"Vr" = (
/obj/machinery/atmospherics/pipe/smart/manifold4w/supply/hidden/layer4,
/obj/machinery/atmospherics/pipe/smart/manifold4w/scrubbers/hidden/layer2,
/obj/effect/decal/cleanable/dirt,
/turf/open/floor/catwalk_floor/iron_smooth,
/area/station/salvage_bay)
"Vy" = (
/obj/structure/railing{
	dir = 4
	},
/obj/effect/decal/cleanable/dirt,
/turf/open/floor/iron/dark/textured_large,
/area/station/salvage_bay)
"VI" = (
/obj/machinery/conveyor{
	dir = 8;
	id = "SalvageProcess"
	},
/obj/machinery/light/small/red/directional/east,
/turf/open/floor/plating,
/area/station/salvage_bay)
"Wd" = (
/obj/machinery/light/red/dim/directional/east,
/obj/structure/sign/poster/random/directional/east,
/turf/open/floor/iron/dark/textured_large,
/area/station/salvage_bay)
"Wj" = (
/obj/effect/spawner/random/engineering/atmospherics_portable,
/turf/open/floor/iron/dark/textured_large,
/area/station/salvage_bay)
"Wn" = (
/obj/machinery/atmospherics/pipe/smart/manifold4w/supply/hidden/layer4,
/obj/machinery/atmospherics/pipe/smart/manifold4w/scrubbers/hidden/layer2,
/turf/open/floor/plating,
/area/station/salvage_bay)
"Wp" = (
/obj/machinery/atmos_shield_gen/active{
	dir = 4
	},
/obj/machinery/conveyor{
	id = "SalvageProcess"
	},
/turf/open/floor/plating,
/area/station/salvage_bay)
"WH" = (
/obj/structure/filingcabinet/chestdrawer,
/obj/machinery/airalarm/directional/east,
/turf/open/floor/iron/dark/textured_large,
/area/station/salvage_bay)
"WM" = (
/obj/effect/spawner/random/engineering/canister,
/obj/machinery/camera/autoname/directional/north,
/turf/open/floor/iron/dark/textured_large,
/area/station/salvage_bay)
"Xx" = (
/obj/effect/decal/cleanable/dirt,
/turf/open/floor/iron/smooth,
/area/station/salvage_bay)
"XA" = (
/obj/structure/railing{
	dir = 1
	},
/turf/open/floor/iron/smooth,
/area/station/salvage_bay)
"XO" = (
/obj/structure/closet/secure_closet/engineering_welding,
/turf/open/floor/iron/dark/textured_large,
/area/station/salvage_bay)
"Ys" = (
/obj/effect/turf_decal/loading_area/red,
/obj/effect/decal/cleanable/dirt/dust,
/turf/open/floor/plating/reinforced/airless,
/area/space/nearstation)
"YX" = (
/obj/structure/railing{
	dir = 1
	},
/turf/open/floor/plating,
/area/station/salvage_bay)
"Zl" = (
/obj/structure/lattice/catwalk,
/obj/structure/marker_beacon/teal,
/turf/open/space/openspace,
/area/space/nearstation)
"ZO" = (
/obj/machinery/suit_storage_unit/engine,
/obj/item/mod/paint{
	pixel_y = 20;
	pixel_x = -3
	},
/turf/open/floor/iron/dark/textured_large,
/area/station/salvage_bay)
"ZU" = (
/obj/structure/lattice/catwalk,
/obj/structure/railing{
	dir = 4
	},
/obj/structure/marker_beacon/yellow,
/turf/open/space/openspace,
/area/space/nearstation)

(1,1,1) = {"
px
ov
ov
ov
ov
ov
ov
ov
ov
ov
ov
ov
ov
ov
ov
ov
ov
ov
ov
px
px
px
px
px
px
px
JB
px
px
px
px
px
px
px
px
px
px
px
"}
(2,1,1) = {"
px
ov
ov
ov
ov
ov
ov
ov
ov
ov
ov
ov
ov
ov
ov
ov
ov
ov
ov
tY
tY
tY
tY
tY
px
px
vk
px
px
px
px
px
px
px
px
px
px
px
"}
(3,1,1) = {"
px
ov
ov
ov
ov
ov
ov
ov
ov
ov
ov
ov
ov
ov
ov
ov
ov
ov
tY
tY
tT
SB
Uw
tY
px
px
aO
FC
FC
px
px
px
px
px
px
px
px
px
"}
(4,1,1) = {"
lu
lu
pw
pw
pw
pw
lu
lu
pw
pw
pw
pw
pw
pw
pw
lu
lu
pw
pi
OW
Jg
Pb
eZ
My
sD
ku
PJ
PJ
Xx
Xx
tY
aQ
Hi
wU
fn
px
px
px
"}
(5,1,1) = {"
pw
lu
ov
ov
ov
ov
lu
lu
ov
ov
ov
ov
ov
ov
ov
lu
lu
ov
pi
jf
ti
me
WH
pi
Wj
Rh
XA
PJ
PJ
Vr
gW
PJ
SM
SM
ra
TX
lx
gz
"}
(6,1,1) = {"
pw
lu
pw
pw
pw
pw
lu
lu
pw
pw
pw
pw
pw
pw
pw
lu
lu
pw
iy
pi
pi
pi
tY
tY
WM
kA
tY
fV
yF
Xx
sD
Xx
lg
za
tY
px
px
px
"}
(7,1,1) = {"
lu
lu
ov
ov
ov
ov
ov
ov
ov
ov
ov
ov
ov
ov
ov
ov
ov
ov
ov
ov
ov
lu
qv
Uz
Uz
tY
tY
wR
wR
eb
yI
tY
Af
fn
Cm
px
px
px
"}
(8,1,1) = {"
pw
lu
ov
ov
ov
ov
ov
ov
ov
ov
ov
ov
ov
ov
ov
ov
ov
ov
ov
ov
ov
lu
UM
Wp
GV
tY
bI
pA
Nd
nN
Wn
tY
Ao
Xx
XO
px
px
px
"}
(9,1,1) = {"
pw
lu
ov
ov
ov
ov
ov
ov
ov
ov
ov
ov
ov
ov
ov
ov
ov
ov
ov
ov
ov
lu
UM
wC
PQ
tY
tD
pA
pA
HV
Wn
PU
cg
DP
tY
px
px
px
"}
(10,1,1) = {"
pw
lu
ov
ov
ov
ov
ov
ov
ov
ov
ov
ov
ov
ov
ov
ov
ov
ov
ov
ov
ov
lu
qv
Uz
ic
tY
pA
ak
ak
nN
Wn
fX
ff
Xx
LV
tY
px
px
"}
(11,1,1) = {"
pw
lu
ov
ov
ov
ov
ov
ov
ov
ov
ov
ov
ov
ov
ov
ov
ov
ov
ov
ov
ov
lu
pw
Uz
fF
ID
Nd
ak
ak
cJ
PL
JS
Vy
Xx
MS
tY
px
px
"}
(12,1,1) = {"
pw
lu
ov
ov
ov
ov
ov
ov
ov
ov
ov
ov
ov
ov
ov
ov
ov
ov
ov
ov
ov
lu
pw
pi
PQ
YX
Nd
pA
mt
nN
PL
tY
Lm
Rh
zm
tY
px
px
"}
(13,1,1) = {"
pw
lu
ov
ov
ov
ov
ov
ov
ov
ov
ov
ov
ov
ov
ov
ov
ov
ov
ov
ov
ov
lu
pw
pi
PQ
Tp
ig
wR
wR
wR
Wn
tY
ZO
Wd
tY
tY
px
px
"}
(14,1,1) = {"
pw
lu
ov
ov
ov
ov
ov
ov
ov
ov
ov
ov
ov
ov
ov
ov
ov
ov
ov
ov
ov
lu
pw
Uz
vq
vq
Df
vq
vq
nP
gh
tY
tY
tY
tY
px
px
px
"}
(15,1,1) = {"
pw
lu
ov
ov
ov
ov
ov
ov
ov
ov
ov
ov
ov
ov
ov
ov
ov
ov
ov
ov
ov
lu
dS
Uz
Uz
tY
tY
Ez
pC
rn
Vr
pi
pw
px
px
px
px
px
"}
(16,1,1) = {"
pw
lu
ov
ov
ov
ov
ov
ov
ov
ov
ov
ov
ov
ov
ov
ov
ov
ov
ov
ov
ov
lu
Ys
Wp
ez
jA
Nt
vq
vq
vq
xa
pi
pw
px
px
px
px
px
"}
(17,1,1) = {"
pw
lu
ov
ov
ov
ov
ov
ov
ov
ov
ov
ov
ov
ov
ov
ov
ov
ov
ov
ov
ov
lu
Ys
wC
ez
VI
tY
Ge
NJ
tw
Vr
pi
pw
px
px
px
px
px
"}
(18,1,1) = {"
pw
lu
ov
ov
ov
ov
ov
ov
ov
ov
ov
ov
ov
ov
ov
ov
ov
ov
ov
ov
ov
lu
dS
Uz
Uz
tY
tY
tY
tY
tY
KP
tY
tY
px
px
px
px
px
"}
(19,1,1) = {"
lu
lu
ov
ov
ov
ov
ov
ov
ov
ov
ov
ov
ov
ov
ov
ov
ov
ov
ov
ov
ov
lu
lu
lu
pw
ov
pw
ov
tY
HV
KE
gM
tY
px
px
px
px
px
"}
(20,1,1) = {"
pw
lu
ov
ov
ov
ov
ov
ov
ov
ov
ov
ov
ov
ov
ov
ov
ov
ov
ov
ov
ov
cz
un
lu
pw
pw
As
pw
tY
xM
kk
nN
tY
px
px
px
px
px
"}
(21,1,1) = {"
pw
lu
ov
ov
ov
ov
ov
ov
ov
ov
ov
ov
ov
ov
ov
ov
ov
ov
ov
ov
ov
un
un
un
pw
ov
pw
ov
tY
tY
Mt
tY
tY
px
px
px
px
px
"}
(22,1,1) = {"
pw
lu
ov
ov
ov
ov
ov
ov
ov
ov
ov
ov
ov
ov
ov
ov
ov
ov
ov
ov
ov
yN
un
un
ZU
ro
ro
lu
lu
ro
ro
ZU
pw
px
px
px
px
px
"}
(23,1,1) = {"
pw
lu
ov
ov
ov
ov
ov
ov
ov
ov
ov
ov
ov
ov
ov
ov
ov
ov
ov
ov
ov
un
un
un
pw
pw
pw
pw
pw
pw
pw
pw
pw
px
px
px
px
px
"}
(24,1,1) = {"
pw
lu
ov
ov
ov
ov
ov
ov
ov
ov
ov
ov
ov
ov
ov
ov
ov
ov
ov
ov
ov
cz
un
lu
pw
ov
px
px
px
px
px
px
px
px
px
px
px
px
"}
(25,1,1) = {"
lu
lu
ov
ov
ov
ov
ov
ov
ov
ov
ov
ov
ov
ov
ov
ov
ov
ov
ov
ov
ov
lu
lu
lu
pw
ov
px
px
px
px
px
px
px
px
px
px
px
px
"}
(26,1,1) = {"
pw
lu
ov
ov
ov
ov
ov
ov
ov
ov
ov
ov
ov
ov
ov
ov
ov
ov
ov
ov
ov
lu
pw
pw
pw
ov
px
px
px
px
px
px
px
px
px
px
px
px
"}
(27,1,1) = {"
pw
lu
ov
ov
ov
ov
ov
ov
ov
ov
ov
ov
ov
ov
ov
ov
ov
ov
ov
ov
ov
lu
pw
ov
ov
ov
px
px
px
px
px
px
px
px
px
px
px
px
"}
(28,1,1) = {"
pw
lu
ov
ov
ov
ov
ov
ov
ov
ov
ov
ov
ov
ov
ov
ov
ov
ov
ov
ov
ov
lu
pw
ov
ov
ov
px
px
px
px
px
px
px
px
px
px
px
px
"}
(29,1,1) = {"
pw
lu
ov
ov
ov
ov
ov
ov
ov
ov
ov
ov
ov
ov
ov
ov
ov
ov
ov
ov
ov
lu
pw
ov
ov
ov
px
px
px
px
px
px
px
px
px
px
px
px
"}
(30,1,1) = {"
pw
lu
ov
ov
ov
ov
ov
ov
ov
ov
ov
ov
ov
ov
ov
ov
ov
ov
ov
ov
ov
lu
pw
ov
ov
ov
px
px
px
px
px
px
px
px
px
px
px
px
"}
(31,1,1) = {"
pw
lu
ov
ov
ov
ov
ov
ov
ov
ov
ov
ov
ov
ov
ov
ov
ov
ov
ov
ov
ov
lu
pw
ov
ov
ov
px
px
px
px
px
px
px
px
px
px
px
px
"}
(32,1,1) = {"
pw
lu
ov
ov
ov
ov
ov
ov
ov
ov
ov
ov
ov
ov
ov
ov
ov
ov
ov
ov
ov
lu
pw
ov
ov
ov
px
px
px
px
px
px
px
px
px
px
px
px
"}
(33,1,1) = {"
pw
lu
ov
ov
ov
ov
ov
ov
ov
ov
ov
ov
ov
ov
ov
ov
ov
ov
ov
ov
ov
lu
pw
ov
ov
ov
px
px
px
px
px
px
px
px
px
px
px
px
"}
(34,1,1) = {"
pw
lu
ov
ov
ov
ov
ov
ov
ov
ov
ov
ov
ov
ov
ov
ov
ov
ov
ov
ov
ov
lu
pw
ov
ov
ov
px
px
px
px
px
px
px
px
px
px
px
px
"}
(35,1,1) = {"
pw
lu
ov
ov
ov
ov
ov
ov
ov
ov
ov
ov
ov
ov
ov
ov
ov
ov
ov
ov
ov
lu
pw
ov
ov
ov
px
px
px
px
px
px
px
px
px
px
px
px
"}
(36,1,1) = {"
pw
lu
ov
ov
ov
ov
ov
ov
ov
ov
ov
ov
ov
ov
ov
ov
ov
ov
ov
ov
ov
lu
pw
ov
ov
ov
px
px
px
px
px
px
px
px
px
px
px
px
"}
(37,1,1) = {"
lu
lu
ov
ov
ov
ov
ov
ov
ov
ov
ov
ov
ov
ov
ov
ov
ov
ov
ov
ov
ov
lu
lu
ov
ov
ov
px
px
px
px
px
px
px
px
px
px
px
px
"}
(38,1,1) = {"
pw
lu
pw
pw
pw
pw
lu
lu
pw
pw
pw
pw
pw
pw
pw
lu
lu
pw
pw
pw
pw
lu
pw
ov
ov
ov
px
px
px
px
px
px
px
px
px
px
px
px
"}
(39,1,1) = {"
pw
lu
ov
ov
ov
ov
lu
lu
ov
ov
ov
ov
ov
ov
ov
lu
lu
ov
ov
ov
ov
lu
pw
ov
ov
ov
px
px
px
px
px
px
px
px
px
px
px
px
"}
(40,1,1) = {"
lu
lu
pw
pw
pw
pw
lu
lu
pw
pw
pw
pw
pw
pw
pw
lu
lu
pw
pw
pw
pw
lu
lu
ov
ov
ov
px
px
px
px
px
px
px
px
px
px
px
px
"}
(41,1,1) = {"
ov
pw
ov
ov
ov
ov
ov
ov
ov
ov
ov
ov
ov
ov
ov
ov
ov
ov
ov
ov
ov
pw
ov
ov
ov
ov
px
px
px
px
px
px
px
px
px
px
px
px
"}
(42,1,1) = {"
ov
pw
ov
ov
ov
ov
ov
ov
ov
ov
ov
ov
ov
ov
ov
ov
ov
ov
ov
ov
ov
pw
ov
ov
ov
ov
px
px
px
px
px
px
px
px
px
px
px
px
"}
(43,1,1) = {"
ov
pw
ov
ov
ov
ov
ov
ov
ov
ov
ov
ov
ov
ov
ov
ov
ov
ov
ov
ov
ov
pw
ov
ov
ov
ov
px
px
px
px
px
px
px
px
px
px
px
px
"}
(44,1,1) = {"
ov
Zl
ov
ov
ov
ov
ov
ov
ov
ov
ov
ov
ov
ov
ov
ov
ov
ov
ov
ov
ov
Zl
ov
ov
ov
ov
px
px
px
px
px
px
px
px
px
px
px
px
"}
